state_abbr,municipio_name,pop,pop_male,pop_female,afromexican,indigenous,metro_area
AGS,Aguascalientes,877190,425731,451459,532,104125,Aguascalientes
AGS,Asientos,46464,22745,23719,3,1691,NA
AGS,Calvillo,56048,27298,28750,10,7358,NA
AGS,Cosío,15577,7552,8025,0,2213,NA
AGS,Jesús María,120405,60135,60270,32,8679,Aguascalientes
AGS,Pabellón de Arteaga,46473,22490,23983,3,6232,NA
AGS,Rincón de Romos,53866,26693,27173,13,6714,NA
AGS,San José de Gracia,8896,4276,4620,13,1733,NA
AGS,Tepezalá,20926,10197,10729,4,3468,NA
AGS,El Llano,20245,9982,10263,0,936,NA
AGS,San Francisco de los Romo,46454,22992,23462,43,10246,Aguascalientes
BC,Ensenada,486639,243180,243459,1139,87804,NA
BC,Mexicali,988417,490894,497523,351,45956,Mexicali
BC,Tecate,102406,51267,51139,186,12812,Tijuana
BC,Tijuana,1641570,816738,824832,5392,126618,Tijuana
BC,Playas de Rosarito,96734,48262,48472,377,9865,Tijuana
BCS,Comondú,72564,36413,36151,111,11275,NA
BCS,Mulegé,60171,31114,29057,6379,9405,NA
BCS,La Paz,272711,133983,138728,1199,33902,NA
BCS,Los Cabos,287671,147981,139690,3321,46719,NA
BCS,Loreto,18912,9646,9266,22,1733,NA
CAMP,Calkiní,56537,27658,28879,16,50632,NA
CAMP,Campeche,283025,135405,147620,515,115523,NA
CAMP,Carmen,248303,122035,126268,2093,59958,NA
CAMP,Champotón,90244,44925,45319,327,50853,NA
CAMP,Hecelchakán,31230,15470,15760,0,25257,NA
CAMP,Hopelchén,40100,20371,19729,9,29624,NA
CAMP,Palizada,8971,4522,4449,2,2463,NA
CAMP,Tenabo,10665,5419,5246,3,9602,NA
CAMP,Escárcega,58553,28886,29667,97,21138,NA
CAMP,Calakmul,28424,14509,13915,224,19297,NA
CAMP,Candelaria,43879,22076,21803,268,16464,NA
COAH,Abasolo,1015,511,504,0,34,NA
COAH,Acuña,147809,73560,74249,112,5723,NA
COAH,Allende,22654,11203,11451,5,290,NA
COAH,Arteaga,23271,11726,11545,378,2193,Saltillo
COAH,Candela,1720,903,817,0,72,NA
COAH,Castaños,28068,13903,14165,0,848,Monclova-Frontera
COAH,Cuatro Ciénegas,13546,6793,6753,8,923,NA
COAH,Escobedo,3077,1557,1520,0,73,NA
COAH,Francisco I. Madero,58360,28863,29497,14,4415,NA
COAH,Frontera,80991,40477,40514,11,4669,Monclova-Frontera
COAH,General Cepeda,12471,6439,6032,1,1080,NA
COAH,Guerrero,1697,891,806,0,130,NA
COAH,Hidalgo,1565,813,752,6,9,NA
COAH,Jiménez,10243,5154,5089,1,182,NA
COAH,Juárez,1574,822,752,0,21,NA
COAH,Lamadrid,1773,905,868,7,36,NA
COAH,Matamoros,108950,54141,54809,6,10766,La Laguna
COAH,Monclova,231107,113720,117387,57,15807,Monclova-Frontera
COAH,Morelos,8599,4379,4220,0,263,NA
COAH,Múzquiz,69102,34921,34181,1152,2159,NA
COAH,Nadadores,6614,3286,3328,0,570,NA
COAH,Nava,30698,15613,15085,2,1317,Piedras Negras
COAH,Ocampo,11671,6040,5631,130,885,NA
COAH,Parras,44799,22797,22002,10,4366,NA
COAH,Piedras Negras,163595,81575,82020,187,12104,Piedras Negras
COAH,Progreso,3304,1714,1590,0,50,NA
COAH,Ramos Arizpe,92828,47275,45553,38,8800,Saltillo
COAH,Sabinas,63522,31856,31666,0,1018,NA
COAH,Sacramento,2360,1178,1182,1,112,NA
COAH,Saltillo,807537,400370,407167,506,56973,Saltillo
COAH,San Buenaventura,23587,11683,11904,0,543,NA
COAH,San Juan de Sabinas,43232,21026,22206,34,1778,NA
COAH,San Pedro,106142,52285,53857,7,7127,NA
COAH,Sierra Mojada,6988,3584,3404,0,143,NA
COAH,Torreón,679288,329932,349356,86,57034,La Laguna
COAH,Viesca,21549,10903,10646,0,1779,NA
COAH,Villa Unión,6352,3253,3099,0,92,NA
COAH,Zaragoza,13257,6561,6696,2,506,NA
COL,Armería,29599,14768,14831,12,7134,Tecomán
COL,Colima,150673,72783,77890,76,23033,Colima-Villa de Álvarez
COL,Comala,21544,10737,10807,8,11771,Colima-Villa de Álvarez
COL,Coquimatlán,20198,10175,10023,5,437,Colima-Villa de Álvarez
COL,Cuauhtémoc,30198,15194,15004,24,5113,Colima-Villa de Álvarez
COL,Ixtlahuacán,5527,2774,2753,2,4114,NA
COL,Manzanillo,184541,92362,92179,453,40704,NA
COL,Minatitlán,8985,4689,4296,5,4899,NA
COL,Tecomán,123191,61315,61876,76,20262,Tecomán
COL,Villa de Álvarez,136779,65994,70785,101,27830,Colima-Villa de Álvarez
CHPS,Acacoyagua,18082,9082,9000,2,1152,NA
CHPS,Acala,31424,15388,16036,0,3297,NA
CHPS,Acapetahua,28380,14139,14241,149,2394,NA
CHPS,Altamirano,32872,16323,16549,2,28859,NA
CHPS,Amatán,19348,9729,9619,0,7697,NA
CHPS,Amatenango de la Frontera,30732,14868,15864,2,6867,NA
CHPS,Amatenango del Valle,9913,4741,5172,0,9546,NA
CHPS,Angel Albino Corzo,28162,13867,14295,13,1347,NA
CHPS,Arriaga,40114,19406,20708,3,1810,NA
CHPS,Bejucal de Ocampo,7494,3742,3752,0,483,NA
CHPS,Bella Vista,20142,10073,10069,0,351,NA
CHPS,Berriozábal,51722,25639,26083,8,7090,NA
CHPS,Bochil,34997,17102,17895,1027,24273,NA
CHPS,El Bosque,22606,10911,11695,1,21907,NA
CHPS,Cacahoatán,45594,22222,23372,41,8771,NA
CHPS,Catazajá,17065,8522,8543,4,351,NA
CHPS,Cintalapa,84455,41504,42951,37,10655,NA
CHPS,Coapilla,9210,4482,4728,0,4336,NA
CHPS,Comitán de Domínguez,153448,72544,80904,32,15900,NA
CHPS,La Concordia,46405,23383,23022,3,4629,NA
CHPS,Copainalá,21800,10573,11227,0,7483,NA
CHPS,Chalchihuitán,16803,8281,8522,1,16597,NA
CHPS,Chamula,87332,40153,47179,1,86345,NA
CHPS,Chanal,12181,6046,6135,0,12044,NA
CHPS,Chapultenango,7644,3843,3801,0,5922,NA
CHPS,Chenalhó,39648,19473,20175,0,38893,NA
CHPS,Chiapa de Corzo,100751,48879,51872,137,17645,Tuxtla Gutiérrez
CHPS,Chiapilla,5899,2962,2937,0,848,NA
CHPS,Chicoasén,5000,2472,2528,0,595,NA
CHPS,Chicomuselo,34744,17206,17538,2,739,NA
CHPS,Chilón,127914,62566,65348,8,122332,NA
CHPS,Escuintla,31822,15772,16050,0,3171,NA
CHPS,Francisco León,7430,3742,3688,0,6791,NA
CHPS,Frontera Comalapa,73436,35669,37767,63,2792,NA
CHPS,Frontera Hidalgo,14416,6987,7429,10,446,NA
CHPS,La Grandeza,7057,3440,3617,0,1235,NA
CHPS,Huehuetán,35017,17042,17975,3,301,NA
CHPS,Huixtán,23625,11549,12076,0,21997,NA
CHPS,Huitiupán,23172,11524,11648,4,16416,NA
CHPS,Huixtla,54332,26157,28175,0,834,NA
CHPS,La Independencia,44891,21863,23028,3,5841,NA
CHPS,Ixhuatán,11342,5555,5787,0,6995,NA
CHPS,Ixtacomitán,10772,5287,5485,0,4926,NA
CHPS,Ixtapa,27198,13452,13746,3,12827,NA
CHPS,Ixtapangajoya,5384,2705,2679,0,786,NA
CHPS,Jiquipilas,39109,19153,19956,3,6195,NA
CHPS,Jitotol,20606,10360,10246,0,15957,NA
CHPS,Juárez,21222,10405,10817,0,2123,NA
CHPS,Larráinzar,23889,11606,12283,0,23702,NA
CHPS,La Libertad,4915,2437,2478,2,383,NA
CHPS,Mapastepec,47932,23532,24400,119,6973,NA
CHPS,Las Margaritas,122821,60805,62016,1,79607,NA
CHPS,Mazapa de Madero,7769,3784,3985,0,3365,NA
CHPS,Mazatán,29239,14351,14888,61,314,NA
CHPS,Metapa,5743,2765,2978,3,243,NA
CHPS,Mitontic,11906,5870,6036,0,11625,NA
CHPS,Motozintla,72967,35669,37298,8,9473,NA
CHPS,Nicolás Ruíz,4262,2166,2096,0,1841,NA
CHPS,Ocosingo,218893,107876,111017,42,180643,NA
CHPS,Ocotepec,12508,6016,6492,0,12366,NA
CHPS,Ocozocoautla de Espinosa,92103,45089,47014,31,25576,NA
CHPS,Ostuacán,18128,9044,9084,3,1715,NA
CHPS,Osumacinta,3682,1838,1844,15,575,NA
CHPS,Oxchuc,48126,23855,24271,0,47325,NA
CHPS,Palenque,119826,58452,61374,15,62883,NA
CHPS,Pantelhó,22011,10790,11221,1,20277,NA
CHPS,Pantepec,12136,5987,6149,0,10471,NA
CHPS,Pichucalco,31107,15291,15816,0,5071,NA
CHPS,Pijijiapan,53525,26432,27093,6,4341,NA
CHPS,El Porvenir,14121,7025,7096,0,1447,NA
CHPS,Villa Comaltitlán,28961,14274,14687,2,1073,NA
CHPS,Pueblo Nuevo Solistahuacán,31942,15002,16940,9,17637,NA
CHPS,Rayón,9578,4693,4885,0,7431,NA
CHPS,Reforma,45104,22450,22654,255,5379,NA
CHPS,Las Rosas,28261,13893,14368,3,12286,NA
CHPS,Sabanilla,26921,13481,13440,0,25073,NA
CHPS,Salto de Agua,63446,31442,32004,16,56219,NA
CHPS,San Cristóbal de las Casas,209591,98208,111383,105,95253,NA
CHPS,San Fernando,39204,19654,19550,11,5613,NA
CHPS,Siltepec,35192,17801,17391,0,226,NA
CHPS,Simojovel,44295,21825,22470,3,36129,NA
CHPS,Sitalá,13844,6828,7016,5,12872,NA
CHPS,Socoltenango,18539,9223,9316,0,3422,NA
CHPS,Solosuchiapa,8082,4047,4035,18,2885,NA
CHPS,Soyaló,10707,5336,5371,0,3010,NA
CHPS,Suchiapa,24049,11958,12091,2,3090,NA
CHPS,Suchiate,38797,18940,19857,27,2817,NA
CHPS,Sunuapa,2283,1138,1145,0,877,NA
CHPS,Tapachula,348156,166181,181975,306,25163,NA
CHPS,Tapalapa,3839,1880,1959,0,3758,NA
CHPS,Tapilula,12887,6186,6701,0,8170,NA
CHPS,Tecpatán,41305,20464,20841,30,17432,NA
CHPS,Tenejapa,43593,20894,22699,1,43225,NA
CHPS,Teopisca,43175,20892,22283,1,27329,NA
CHPS,Tila,77554,38649,38905,5,75419,NA
CHPS,Tonalá,89178,44061,45117,315,2708,NA
CHPS,Totolapa,7284,3641,3643,0,1494,NA
CHPS,La Trinitaria,76917,37472,39445,14,15008,NA
CHPS,Tumbalá,34305,16619,17686,1,33788,NA
CHPS,Tuxtla Gutiérrez,598710,283753,314957,412,63004,Tuxtla Gutiérrez
CHPS,Tuxtla Chico,41823,20219,21604,4,1315,NA
CHPS,Tuzantán,31755,15631,16124,580,4371,NA
CHPS,Tzimol,15316,7431,7885,2,284,NA
CHPS,Unión Juárez,15350,7502,7848,5,2438,NA
CHPS,Venustiano Carranza,65009,32023,32986,5,22652,NA
CHPS,Villa Corzo,79003,38600,40403,6,7634,NA
CHPS,Villaflores,104833,51017,53816,8,3135,NA
CHPS,Yajalón,37833,18392,19441,0,30617,NA
CHPS,San Lucas,7202,3521,3681,0,1008,NA
CHPS,Zinacantán,41112,19151,21961,0,40394,NA
CHPS,San Juan Cancuc,34829,16977,17852,0,34493,Tuxtla Gutiérrez
CHPS,Aldama,6712,3223,3489,0,6653,NA
CHPS,Benemérito de las Américas,20193,10196,9997,19,7555,NA
CHPS,Maravilla Tenejapa,12945,6467,6478,0,9300,NA
CHPS,Marqués de Comillas,11444,5800,5644,3,6325,NA
CHPS,Montecristo de Guerrero,7682,3852,3830,0,445,NA
CHPS,San Andrés Duraznal,5163,2514,2649,0,5021,NA
CHPS,Santiago el Pinar,3684,1857,1827,0,3667,NA
CHIH,Ahumada,12568,6271,6297,0,898,NA
CHIH,Aldama,24761,12269,12492,7,2917,Chihuahua
CHIH,Allende,8751,4407,4344,0,598,NA
CHIH,Aquiles Serdán,15516,7646,7870,0,1718,Chihuahua
CHIH,Ascensión,24966,12386,12580,21,2370,NA
CHIH,Bachíniva,6156,3125,3031,2,339,NA
CHIH,Balleza,16824,8472,8352,2,11446,NA
CHIH,Batopilas,11289,5601,5688,0,7044,NA
CHIH,Bocoyna,27909,13517,14392,0,14868,NA
CHIH,Buenaventura,23438,11828,11610,0,0,NA
CHIH,Camargo,51572,25129,26443,4,4827,NA
CHIH,Carichí,9211,4635,4576,0,0,NA
CHIH,Casas Grandes,11432,5863,5569,4,933,NA
CHIH,Coronado,2096,1090,1006,0,12,NA
CHIH,Coyame del Sotol,1684,926,758,0,226,NA
CHIH,La Cruz,3861,1971,1890,1,294,NA
CHIH,Cuauhtémoc,168482,80225,88257,98,24949,NA
CHIH,Cusihuiriachi,4594,2370,2224,0,493,NA
CHIH,Chihuahua,878062,427488,450574,250,70418,Chihuahua
CHIH,Chínipas,7501,3870,3631,0,2932,NA
CHIH,Delicias,148045,71512,76533,29,12838,NA
CHIH,Dr. Belisario Domínguez,2491,1270,1221,1,451,NA
CHIH,Galeana,6021,3023,2998,129,1308,NA
CHIH,Santa Isabel,4099,2013,2086,0,0,NA
CHIH,Gómez Farías,8905,4492,4413,2,1406,NA
CHIH,Gran Morelos,2466,1250,1216,0,326,NA
CHIH,Guachochi,45544,21974,23570,11,32249,NA
CHIH,Guadalupe,5272,2579,2693,11,465,NA
CHIH,Guadalupe y Calvo,56130,28109,28021,1,30012,NA
CHIH,Guazapares,7429,3714,3715,0,2796,NA
CHIH,Guerrero,39064,19664,19400,16,12325,NA
CHIH,Hidalgo del Parral,109510,53219,56291,16,8677,NA
CHIH,Huejotitán,952,472,480,0,148,NA
CHIH,Ignacio Zaragoza,6903,3435,3468,0,952,NA
CHIH,Janos,10974,5658,5316,56,646,NA
CHIH,Jiménez,42860,21069,21791,0,2101,NA
CHIH,Juárez,1391180,691131,700049,2000,100092,Juárez
CHIH,Julimes,4448,2222,2226,0,580,NA
CHIH,López,4007,2050,1957,0,319,NA
CHIH,Madera,29233,14578,14655,0,9504,NA
CHIH,Maguarichi,1593,798,795,0,1162,NA
CHIH,Manuel Benavides,1403,756,647,1,162,NA
CHIH,Matachí,2961,1471,1490,2,837,NA
CHIH,Matamoros,4371,2232,2139,0,432,NA
CHIH,Meoqui,44752,21867,22885,4,2048,NA
CHIH,Morelos,7797,3941,3856,0,5391,NA
CHIH,Moris,5141,2605,2536,0,1333,NA
CHIH,Namiquipa,23255,11960,11295,9,1357,NA
CHIH,Nonoava,2574,1296,1278,0,1749,NA
CHIH,Nuevo Casas Grandes,63412,30948,32464,11,5272,NA
CHIH,Ocampo,7569,3874,3695,0,3770,NA
CHIH,Ojinaga,28040,13932,14108,21,1989,NA
CHIH,Praxedis G. Guerrero,5486,2753,2733,2,874,NA
CHIH,Riva Palacio,7969,4038,3931,0,280,NA
CHIH,Rosales,16896,8435,8461,0,469,NA
CHIH,Rosario,2018,1048,970,0,754,NA
CHIH,San Francisco de Borja,2136,1092,1044,1,682,NA
CHIH,San Francisco de Conchos,2471,1265,1206,0,24,NA
CHIH,San Francisco del Oro,5086,2549,2537,0,255,NA
CHIH,Santa Bárbara,10721,5307,5414,6,1088,NA
CHIH,Satevó,3159,1619,1540,0,211,NA
CHIH,Saucillo,31196,15556,15640,20,1761,NA
CHIH,Temósachic,6425,3226,3199,0,0,NA
CHIH,El Tule,1697,864,833,0,367,NA
CHIH,Urique,20947,10560,10387,0,0,NA
CHIH,Uruachi,6094,3132,2962,0,4391,NA
CHIH,Valle de Zaragoza,5199,2628,2571,0,60,NA
CDMX,Azcapotzalco,400161,187331,212830,4783,30143,Valle de México
CDMX,Coyoacán,608479,283782,324697,17299,54025,Valle de México
CDMX,Cuajimalpa de Morelos,199224,95854,103370,3149,19223,Valle de México
CDMX,Gustavo A. Madero,1164477,555140,609337,9241,76478,Valle de México
CDMX,Iztacalco,390348,183949,206399,6789,26687,Valle de México
CDMX,Iztapalapa,1827868,878365,949503,25313,143830,Valle de México
CDMX,La Magdalena Contreras,243886,117099,126787,4713,23781,Valle de México
CDMX,Milpa Alta,137927,67151,70776,1340,28024,Valle de México
CDMX,Álvaro Obregón,749982,355754,394228,17369,69333,Valle de México
CDMX,Tláhuac,361593,172825,188768,12840,52910,Valle de México
CDMX,Tlalpan,677104,321125,355979,13220,80213,Valle de México
CDMX,Xochimilco,415933,199513,216420,7500,51522,Valle de México
CDMX,Benito Juárez,417416,193007,224409,12524,39119,Valle de México
CDMX,Cuauhtémoc,532553,253238,279315,14339,46004,Valle de México
CDMX,Miguel Hidalgo,364439,167085,197354,5237,18274,Valle de México
CDMX,Venustiano Carranza,427263,200432,226831,4697,25039,Valle de México
DGO,Canatlán,32852,16064,16788,0,1303,NA
DGO,Canelas,4683,2397,2286,0,18,NA
DGO,Coneto de Comonfort,4390,2191,2199,0,42,NA
DGO,Cuencamé,35415,17772,17643,9,1497,NA
DGO,Durango,654876,314828,340048,80,35613,NA
DGO,General Simón Bolívar,10110,4966,5144,0,489,NA
DGO,Gómez Palacio,342286,168419,173867,25,14354,La Laguna
DGO,Guadalupe Victoria,35380,17314,18066,13,1635,NA
DGO,Guanaceví,9851,5038,4813,0,4807,NA
DGO,Hidalgo,3838,1928,1910,4,297,NA
DGO,Indé,4927,2488,2439,4,815,NA
DGO,Lerdo,153311,76157,77154,2,6774,La Laguna
DGO,Mapimí,26502,13165,13337,10,4545,NA
DGO,Mezquital,39288,19177,20111,7,33934,NA
DGO,Nazas,12957,6447,6510,0,239,NA
DGO,Nombre de Dios,19694,9833,9861,0,2777,NA
DGO,Ocampo,9567,4845,4722,0,1420,NA
DGO,El Oro,11496,5670,5826,2,1040,NA
DGO,Otáez,5385,2780,2605,0,52,NA
DGO,Pánuco de Coronado,12290,6044,6246,0,35,NA
DGO,Peñón Blanco,10922,5418,5504,0,428,NA
DGO,Poanas,25241,12504,12737,0,1489,NA
DGO,Pueblo Nuevo,50417,24976,25441,0,11173,NA
DGO,Rodeo,13554,6821,6733,1,285,NA
DGO,San Bernardo,3205,1713,1492,0,601,NA
DGO,San Dimas,19383,9936,9447,0,46,NA
DGO,San Juan de Guadalupe,5564,2737,2827,0,213,NA
DGO,San Juan del Río,12747,6295,6452,0,44,NA
DGO,San Luis del Cordero,2077,1046,1031,3,160,NA
DGO,San Pedro del Gallo,1478,775,703,0,145,NA
DGO,Santa Clara,7089,3516,3573,2,533,NA
DGO,Santiago Papasquiaro,48482,24164,24318,8,3298,NA
DGO,Súchil,6343,3046,3297,0,497,NA
DGO,Tamazula,26709,13794,12915,0,496,NA
DGO,Tepehuanes,11060,5563,5497,6,2697,NA
DGO,Tlahualilo,22895,11600,11295,7,1805,NA
DGO,Topia,9351,4825,4526,4,617,NA
DGO,Vicente Guerrero,21861,10597,11264,0,576,NA
DGO,Nuevo Ideal,27278,13533,13745,3,2618,NA
GTO,Abasolo,90990,44086,46904,6,3229,NA
GTO,Acámbaro,112125,53812,58313,30,15050,NA
GTO,San Miguel de Allende,171857,82458,89399,21,12710,NA
GTO,Apaseo el Alto,68455,32895,35560,18,6568,NA
GTO,Apaseo el Grande,92605,44407,48198,6,7222,NA
GTO,Atarjea,5128,2481,2647,0,475,NA
GTO,Celaya,494304,237649,256655,359,47639,Celaya
GTO,Manuel Doblado,38832,18609,20223,3,2867,NA
GTO,Comonfort,82572,38810,43762,5,14646,Celaya
GTO,Coroneo,12068,5687,6381,0,843,NA
GTO,Cortazar,95961,45993,49968,15,11454,NA
GTO,Cuerámaro,28320,13516,14804,0,1466,NA
GTO,Doctor Mora,24219,11522,12697,2,1197,NA
GTO,Dolores Hidalgo Cuna de la Independencia Nacional,152113,70636,81477,8,16257,NA
GTO,Guanajuato,184239,89432,94807,55,16240,NA
GTO,Huanímaro,21638,10253,11385,8,2174,NA
GTO,Irapuato,574344,277673,296671,156,25624,NA
GTO,Jaral del Progreso,38412,18916,19496,6,8630,NA
GTO,Jerécuaro,49053,22666,26387,0,7061,NA
GTO,León,1578626,775407,803219,910,137830,León
GTO,Moroleón,50377,24005,26372,4,776,Moroleón-Uriangato
GTO,Ocampo,23528,11276,12252,0,2493,NA
GTO,Pénjamo,150570,72049,78521,33,16474,La Piedad-Pénjamo
GTO,Pueblo Nuevo,11872,5661,6211,0,1204,NA
GTO,Purísima del Rincón,79798,39667,40131,60,10481,San Francisco del Rincón
GTO,Romita,59879,28992,30887,3,752,NA
GTO,Salamanca,273271,131361,141910,118,33609,NA
GTO,Salvatierra,100391,47544,52847,18,9752,NA
GTO,San Diego de la Unión,39668,18250,21418,9,4121,NA
GTO,San Felipe,113109,54492,58617,22,11123,NA
GTO,San Francisco del Rincón,119510,57341,62169,45,21004,San Francisco del Rincón
GTO,San José Iturbide,78794,37941,40853,26,5939,NA
GTO,San Luis de la Paz,121027,56918,64109,21,14113,NA
GTO,Santa Catarina,5261,2516,2745,3,1128,NA
GTO,Santa Cruz de Juventino Rosas,83060,39624,43436,0,5578,NA
GTO,Santiago Maravatío,6824,3259,3565,1,712,NA
GTO,Silao de la Victoria,189567,92949,96618,5,6819,León
GTO,Tarandacuao,12256,5785,6471,0,1517,NA
GTO,Tarimoro,34263,16750,17513,4,1550,NA
GTO,Tierra Blanca,18960,9016,9944,0,15160,NA
GTO,Uriangato,62761,30153,32608,6,4258,Moroleón-Uriangato
GTO,Valle de Santiago,142672,67281,75391,0,7338,NA
GTO,Victoria,20166,9426,10740,4,5498,NA
GTO,Villagrán,58830,28550,30280,44,9932,Celaya
GTO,Xichú,11639,5476,6163,0,6,NA
GTO,Yuriria,69763,33179,36584,12,3919,NA
GRO,Acapulco de Juárez,810669,385812,424857,77837,164595,Acapulco
GRO,Ahuacuotzingo,26858,12543,14315,1128,22378,NA
GRO,Ajuchitlán del Progreso,38134,18592,19542,20,903,NA
GRO,Alcozauca de Guerrero,19368,9102,10266,103,18792,NA
GRO,Alpoyeca,6657,3163,3494,232,4275,NA
GRO,Apaxtla,11159,5358,5801,133,1506,NA
GRO,Arcelia,31406,15219,16187,52,1493,NA
GRO,Atenango del Río,8731,4197,4534,216,4999,NA
GRO,Atlamajalcingo del Monte,5476,2572,2904,33,5305,NA
GRO,Atlixtac,27212,13167,14045,1138,25102,NA
GRO,Atoyac de Álvarez,60382,29636,30746,1113,16622,NA
GRO,Ayutla de los Libres,69716,33850,35866,8343,37653,NA
GRO,Azoyú,14865,7376,7489,3161,7332,NA
GRO,Benito Juárez,15318,7449,7869,966,2431,NA
GRO,Buenavista de Cuéllar,13286,6502,6784,402,2156,NA
GRO,Coahuayutla de José María Izazaga,12725,6486,6239,44,263,NA
GRO,Cocula,13457,6550,6907,18,1381,NA
GRO,Copala,14304,6993,7311,2615,2667,NA
GRO,Copalillo,14866,7112,7754,2076,14021,NA
GRO,Copanatoyac,20192,9519,10673,243,19716,NA
GRO,Coyuca de Benítez,76306,37456,38850,3511,14476,Acapulco
GRO,Coyuca de Catalán,39002,19119,19883,14,102,NA
GRO,Cuajinicuilapa,27266,13642,13624,15388,9453,NA
GRO,Cualác,7649,3752,3897,25,7068,NA
GRO,Cuautepec,16415,8139,8276,2449,3664,NA
GRO,Cuetzala del Progreso,8559,4211,4348,42,1595,NA
GRO,Cutzamala de Pinzón,19746,9647,10099,24,441,NA
GRO,Chilapa de Álvarez,129867,60648,69219,6870,91968,NA
GRO,Chilpancingo de los Bravo,273106,130069,143037,13392,50159,NA
GRO,Florencio Villarreal,20855,10286,10569,6270,6084,NA
GRO,General Canuto A. Neri,5780,2789,2991,42,1045,NA
GRO,General Heliodoro Castillo,37340,18375,18965,114,3214,NA
GRO,Huamuxtitlán,15287,7174,8113,131,10202,NA
GRO,Huitzuco de los Figueroa,37094,17938,19156,959,14641,NA
GRO,Iguala de la Independencia,151660,73088,78572,3457,31639,NA
GRO,Igualapa,11383,5589,5794,2649,6296,NA
GRO,Ixcateopan de Cuauhtémoc,6179,2938,3241,94,1050,NA
GRO,Zihuatanejo de Azueta,124824,60936,63888,10059,31084,NA
GRO,Juan R. Escudero,24890,12026,12864,655,3585,NA
GRO,Leonardo Bravo,26342,12912,13430,60,3541,NA
GRO,Malinaltepec,25584,12031,13553,1527,24910,NA
GRO,Mártir de Cuilapan,18526,8802,9724,396,14988,NA
GRO,Metlatónoc,19456,9192,10264,178,19095,NA
GRO,Mochitlán,12752,6185,6567,745,1872,NA
GRO,Olinalá,25483,12283,13200,2185,21003,NA
GRO,Ometepec,67641,32684,34957,7198,32616,NA
GRO,Pedro Ascencio Alquisiras,6883,3220,3663,6,267,NA
GRO,Petatlán,44263,21730,22533,558,5416,NA
GRO,Pilcaya,12900,6279,6621,282,1370,NA
GRO,Pungarabato,37494,18074,19420,183,2623,NA
GRO,Quechultenango,35926,17610,18316,338,7356,NA
GRO,San Luis Acatlán,43671,21367,22304,3596,31049,NA
GRO,San Marcos,49449,24300,25149,5529,12800,NA
GRO,San Miguel Totolapan,27853,13585,14268,166,1920,NA
GRO,Taxco de Alarcón,108416,51275,57141,2582,18836,NA
GRO,Tecoanapa,46812,22993,23819,1007,6023,NA
GRO,Técpan de Galeana,64577,31966,32611,631,7989,NA
GRO,Teloloapan,57377,26925,30452,594,9101,NA
GRO,Tepecoacuilco de Trujano,31599,15267,16332,324,10488,NA
GRO,Tetipac,14658,7147,7511,497,2187,NA
GRO,Tixtla de Guerrero,42653,20310,22343,1615,20490,NA
GRO,Tlacoachistlahuaca,22771,10654,12117,1386,20725,NA
GRO,Tlacoapa,9753,4651,5102,60,9631,NA
GRO,Tlalchapa,12404,6220,6184,82,196,NA
GRO,Tlalixtaquilla de Maldonado,7407,3568,3839,868,4617,NA
GRO,Tlapa de Comonfort,87967,41047,46920,9806,76280,NA
GRO,Tlapehuala,21995,10596,11399,250,319,NA
GRO,La Unión de Isidoro Montes de Oca,26432,13431,13001,370,3094,NA
GRO,Xalpatláhuac,11726,5378,6348,89,11507,NA
GRO,Xochihuehuetlán,7201,3413,3788,19,3950,NA
GRO,Xochistlahuaca,28839,13844,14995,1751,27796,NA
GRO,Zapotitlán Tablas,11221,5377,5844,741,11043,NA
GRO,Zirándaro,18206,9112,9094,15,703,NA
GRO,Zitlala,22721,10682,12039,978,20305,NA
GRO,Eduardo Neri,51316,24919,26397,6929,21450,NA
GRO,Acatepec,36449,17778,18671,830,35818,NA
GRO,Marquelia,13730,6791,6939,3581,5870,NA
GRO,Cochoapa el Grande,18458,8784,9674,44,18283,NA
GRO,José Joaquín de Herrera,17661,8657,9004,57,17473,NA
GRO,Juchitán,7576,3819,3757,2813,2219,NA
GRO,Iliatenco,11114,5181,5933,2630,9787,NA
HGO,Acatlán,21044,10064,10980,14,4687,NA
HGO,Acaxochitlán,43774,20864,22910,11,29707,NA
HGO,Actopan,56429,26575,29854,0,18019,NA
HGO,Agua Blanca de Iturbide,9116,4270,4846,2,952,NA
HGO,Ajacuba,18320,8843,9477,12,2394,NA
HGO,Alfajayucan,20332,9815,10517,17,16543,NA
HGO,Almoloya,12410,6105,6305,2,586,NA
HGO,Apan,44576,21265,23311,10,4487,NA
HGO,El Arenal,18807,8951,9856,20,5600,NA
HGO,Atitalaquia,29683,14509,15174,56,5541,Tula
HGO,Atlapexco,19902,9518,10384,0,17846,NA
HGO,Atotonilco el Grande,27433,12931,14502,3,3467,NA
HGO,Atotonilco de Tula,38564,18695,19869,72,5324,Tula
HGO,Calnali,17163,8226,8937,0,15377,NA
HGO,Cardonal,18347,8694,9653,6,17208,NA
HGO,Cuautepec de Hinojosa,58301,27716,30585,0,2372,Tulancingo
HGO,Chapantongo,13789,6583,7206,11,6057,NA
HGO,Chapulhuacán,23961,11842,12119,9,8365,NA
HGO,Chilcuautla,18169,8935,9234,54,15836,NA
HGO,Eloxochitlán,2667,1238,1429,2,737,NA
HGO,Emiliano Zapata,14825,7001,7824,20,2992,NA
HGO,Epazoyucan,14693,7057,7636,0,1609,Pachuca
HGO,Francisco I. Madero,35872,17105,18767,25,10249,NA
HGO,Huasca de Ocampo,17728,8363,9365,4,2925,NA
HGO,Huautla,21244,10197,11047,2,19570,NA
HGO,Huazalingo,13986,6676,7310,1,12918,NA
HGO,Huehuetla,25989,12458,13531,3,21365,NA
HGO,Huejutla de Reyes,129919,63037,66882,31,108522,NA
HGO,Huichapan,45959,21949,24010,26,11881,NA
HGO,Ixmiquilpan,93502,43832,49670,41,70381,NA
HGO,Jacala de Ledezma,13399,6294,7105,0,3145,NA
HGO,Jaltocán,11818,5727,6091,6,11454,NA
HGO,Juárez Hidalgo,3108,1473,1635,0,949,NA
HGO,Lolotla,9461,4513,4948,0,5097,NA
HGO,Metepec,11801,5518,6283,1,1463,NA
HGO,San Agustín Metzquititlán,9437,4506,4931,2,1187,NA
HGO,Metztitlán,20111,9554,10557,14,6968,NA
HGO,Mineral del Chico,9028,4333,4695,3,2256,NA
HGO,Mineral del Monte,14640,6983,7657,5,1247,Pachuca
HGO,La Misión,10139,4942,5197,0,2009,NA
HGO,Mixquiahuala de Juárez,46224,22234,23990,16,15883,NA
HGO,Molango de Escamilla,11587,5600,5987,0,5216,NA
HGO,Nicolás Flores,7031,3278,3753,0,6494,NA
HGO,Nopala de Villagrán,16896,8258,8638,0,1700,NA
HGO,Omitlán de Juárez,9636,4651,4985,0,3504,NA
HGO,San Felipe Orizatlán,38952,18799,20153,5,33647,NA
HGO,Pacula,5139,2393,2746,0,801,NA
HGO,Pachuca de Soto,277375,131138,146237,223,42586,Pachuca
HGO,Pisaflores,17379,8577,8802,3,951,NA
HGO,Progreso de Obregón,23451,11016,12435,2,10066,NA
HGO,Mineral de la Reforma,150176,70224,79952,211,19943,Pachuca
HGO,San Agustín Tlaxiaca,36079,17464,18615,0,8079,Pachuca
HGO,San Bartolo Tutotepec,18986,9291,9695,4,15174,NA
HGO,San Salvador,35547,17053,18494,16,26103,NA
HGO,Santiago de Anaya,17032,8355,8677,11,15031,NA
HGO,Santiago Tulantepec de Lugo Guerrero,37292,17734,19558,69,4870,Tulancingo
HGO,Singuilucan,16235,8032,8203,2,956,NA
HGO,Tasquillo,16403,7614,8789,14,14163,NA
HGO,Tecozautla,37674,18115,19559,15,19445,NA
HGO,Tenango de Doria,18766,8699,10067,0,15540,NA
HGO,Tepeapulco,54373,26434,27939,71,7883,NA
HGO,Tepehuacán de Guerrero,30750,15283,15467,2,23820,NA
HGO,Tepeji del Río de Ocampo,87442,42652,44790,71,10876,NA
HGO,Tepetitlán,10932,5326,5606,4,3216,NA
HGO,Tetepango,11624,5802,5822,0,2238,NA
HGO,Villa de Tezontepec,12413,5973,6440,6,1932,NA
HGO,Tezontepec de Aldama,53009,25928,27081,68,25205,NA
HGO,Tianguistengo,15122,7355,7767,10,6869,NA
HGO,Tizayuca,119442,57785,61657,338,21222,Valle de México
HGO,Tlahuelilpan,19389,9439,9950,11,8439,Tula
HGO,Tlahuiltepa,10376,5174,5202,6,2184,NA
HGO,Tlanalapa,10342,4964,5378,0,228,NA
HGO,Tlanchinol,39772,19530,20242,37,33302,NA
HGO,Tlaxcoapan,28490,14017,14473,3,4901,Tula
HGO,Tolcayuca,16733,8098,8635,14,3673,NA
HGO,Tula de Allende,109093,52404,56689,129,22147,Tula
HGO,Tulancingo de Bravo,161069,76322,84747,112,22019,Tulancingo
HGO,Xochiatipan,19752,9432,10320,5,19023,NA
HGO,Xochicoatlán,7706,3773,3933,2,4059,NA
HGO,Yahualica,24173,11761,12412,1,23120,NA
HGO,Zacualtipán de Ángeles,34720,16482,18238,63,14443,NA
HGO,Zapotlán de Juárez,18748,8894,9854,4,3484,Pachuca
HGO,Zempoala,45382,21985,23397,28,7196,Pachuca
HGO,Zimapán,40201,18530,21671,6,24136,NA
JAL,Acatic,21530,10466,11064,21,4410,NA
JAL,Acatlán de Juárez,22261,10914,11347,0,155,NA
JAL,Ahualulco de Mercado,23362,11371,11991,4,4239,NA
JAL,Amacueca,5385,2654,2731,0,1264,NA
JAL,Amatitán,15344,7522,7822,0,1284,NA
JAL,Ameca,60951,29729,31222,27,8340,NA
JAL,San Juanito de Escobedo,9420,4729,4691,0,1399,NA
JAL,Arandas,77116,36623,40493,0,4712,NA
JAL,El Arenal,19900,9856,10044,2,288,NA
JAL,Atemajac de Brizuela,6717,3311,3406,0,36,NA
JAL,Atengo,5475,2818,2657,0,3560,NA
JAL,Atenguillo,3899,1910,1989,0,303,NA
JAL,Atotonilco el Alto,60480,29623,30857,0,548,NA
JAL,Atoyac,8264,3973,4291,1,2964,NA
JAL,Autlán de Navarro,60572,29573,30999,186,7937,NA
JAL,Ayotlán,37963,18526,19437,0,2313,NA
JAL,Ayutla,12453,6206,6247,2,3257,NA
JAL,La Barca,65055,31487,33568,5,3769,NA
JAL,Bolaños,7341,3648,3693,0,4687,NA
JAL,Cabo Corrientes,10303,5302,5001,2,2846,NA
JAL,Casimiro Castillo,21584,10751,10833,20,6098,NA
JAL,Cihuatlán,41300,20698,20602,115,3837,NA
JAL,Zapotlán el Grande,105423,51215,54208,104,19630,NA
JAL,Cocula,26687,12997,13690,4,3053,NA
JAL,Colotlán,17865,8618,9247,2,646,NA
JAL,Concepción de Buenos Aires,6088,3103,2985,0,757,NA
JAL,Cuautitlán de García Barragán,18138,9112,9026,0,12298,NA
JAL,Cuautla,2120,1020,1100,0,404,NA
JAL,Cuquío,17980,8566,9414,0,5219,NA
JAL,Chapala,50738,24604,26134,21,9575,NA
JAL,Chimaltitán,3383,1659,1724,0,1563,NA
JAL,Chiquilistlán,6102,3103,2999,0,2475,NA
JAL,Degollado,21479,10461,11018,0,1224,NA
JAL,Ejutla,1862,960,902,4,125,NA
JAL,Encarnación de Díaz,53555,25766,27789,29,2122,NA
JAL,Etzatlán,19847,9545,10302,2,3016,NA
JAL,El Grullo,24312,11663,12649,3,1603,NA
JAL,Guachinango,4184,2140,2044,0,81,NA
JAL,Guadalajara,1460148,704282,755866,22484,98035,Guadalajara
JAL,Hostotipaquillo,9761,4996,4765,3,740,NA
JAL,Huejúcar,5633,2702,2931,0,749,NA
JAL,Huejuquilla el Alto,8787,4198,4589,0,1142,NA
JAL,La Huerta,24563,12447,12116,19,9665,NA
JAL,Ixtlahuacán de los Membrillos,53045,26188,26857,343,5158,Guadalajara
JAL,Ixtlahuacán del Río,19070,9222,9848,4,2916,NA
JAL,Jalostotitlán,33777,16684,17093,0,2898,NA
JAL,Jamay,24753,12334,12419,2,2590,NA
JAL,Jesús María,19469,8819,10650,5,2399,NA
JAL,Jilotlán de los Dolores,9917,4981,4936,0,28,NA
JAL,Jocotepec,46521,22921,23600,18,15124,NA
JAL,Juanacatlán,17955,8965,8990,379,2795,Guadalajara
JAL,Juchitlán,5638,2771,2867,0,448,NA
JAL,Lagos de Moreno,164981,80582,84399,102,29190,NA
JAL,El Limón,5379,2680,2699,0,243,NA
JAL,Magdalena,22643,11286,11357,10,5334,NA
JAL,Santa María del Oro,2028,1007,1021,0,89,NA
JAL,La Manzanilla de la Paz,3688,1778,1910,0,491,NA
JAL,Mascota,14477,7060,7417,0,2775,NA
JAL,Mazamitla,13799,6604,7195,0,2198,NA
JAL,Mexticacán,5088,2357,2731,0,570,NA
JAL,Mezquitic,19452,9345,10107,0,14639,NA
JAL,Mixtlán,3526,1768,1758,0,11,NA
JAL,Ocotlán,99461,48541,50920,52,12778,Ocotlán
JAL,Ojuelos de Jalisco,32357,15623,16734,3,3870,NA
JAL,Pihuamo,11192,5650,5542,10,2020,NA
JAL,Poncitlán,51944,25480,26464,26,29725,Ocotlán
JAL,Puerto Vallarta,275640,137779,137861,865,53346,Puerto Vallarta
JAL,Villa Purificación,10704,5557,5147,6,3873,NA
JAL,Quitupan,8379,4017,4362,0,356,NA
JAL,El Salto,183437,91233,92204,546,7296,Guadalajara
JAL,San Cristóbal de la Barranca,3117,1559,1558,0,118,NA
JAL,San Diego de Alejandría,7349,3539,3810,0,949,NA
JAL,San Juan de los Lagos,69725,34533,35192,10,4368,NA
JAL,San Julián,15890,7518,8372,0,666,NA
JAL,San Marcos,3783,1882,1901,0,1164,NA
JAL,San Martín de Bolaños,3122,1548,1574,0,147,NA
JAL,San Martín Hidalgo,27777,13554,14223,0,452,NA
JAL,San Miguel el Alto,32960,16093,16867,0,886,NA
JAL,Gómez Farías,14278,6810,7468,1,4277,NA
JAL,San Sebastián del Oeste,5643,2952,2691,0,1062,NA
JAL,Santa María de los Ángeles,3033,1451,1582,0,45,NA
JAL,Sayula,36778,17606,19172,3,6816,NA
JAL,Tala,80365,39532,40833,16,16536,NA
JAL,Talpa de Allende,15126,7615,7511,0,2243,NA
JAL,Tamazula de Gordiano,38396,18692,19704,5,4360,NA
JAL,Tapalpa,19506,9489,10017,5,5575,NA
JAL,Tecalitlán,16579,8096,8483,3,1158,NA
JAL,Tecolotlán,17257,8539,8718,0,2273,NA
JAL,Techaluta de Montenegro,3703,1827,1876,0,648,NA
JAL,Tenamaxtlán,7005,3501,3504,6,2390,NA
JAL,Teocaltiche,41278,19826,21452,10,5687,NA
JAL,Teocuitatlán de Corona,10317,5054,5263,0,1914,NA
JAL,Tepatitlán de Morelos,141322,69100,72222,15,13652,NA
JAL,Tequila,42009,20655,21354,24,5399,NA
JAL,Teuchitlán,9608,4705,4903,30,2004,NA
JAL,Tizapán el Alto,20961,10165,10796,15,3893,NA
JAL,Tlajomulco de Zúñiga,549442,269701,279741,4264,49027,Guadalajara
JAL,San Pedro Tlaquepaque,664193,328802,335391,9506,60298,Guadalajara
JAL,Tolimán,10310,5127,5183,0,3203,NA
JAL,Tomatlán,35824,18218,17606,3,6994,NA
JAL,Tonalá,536111,262559,273552,5739,54472,Guadalajara
JAL,Tonaya,5960,2932,3028,0,104,NA
JAL,Tonila,7919,3955,3964,1,612,NA
JAL,Totatiche,4412,2219,2193,1,640,NA
JAL,Tototlán,23171,11495,11676,26,3523,NA
JAL,Tuxcacuesco,4229,2148,2081,1,166,NA
JAL,Tuxcueca,6156,2946,3210,0,879,NA
JAL,Tuxpan,34535,16761,17774,7,19454,NA
JAL,Unión de San Antonio,17915,8667,9248,4,2707,NA
JAL,Unión de Tula,13446,6498,6948,2,1652,NA
JAL,Valle de Guadalupe,6924,3421,3503,0,59,NA
JAL,Valle de Juárez,5389,2630,2759,0,610,NA
JAL,San Gabriel,16105,7847,8258,8,1296,NA
JAL,Villa Corona,17824,8731,9093,9,85,NA
JAL,Villa Guerrero,5417,2661,2756,0,568,NA
JAL,Villa Hidalgo,20257,9712,10545,15,2754,NA
JAL,Cañadas de Obregón,4110,2020,2090,17,330,NA
JAL,Yahualica de González Gallo,22586,10812,11774,0,192,NA
JAL,Zacoalco de Torres,28205,14038,14167,0,351,NA
JAL,Zapopan,1332272,649671,682601,15906,111214,Guadalajara
JAL,Zapotiltic,29190,14282,14908,9,1558,NA
JAL,Zapotitlán de Vadillo,7027,3559,3468,2,5198,NA
JAL,Zapotlán del Rey,17893,8927,8966,17,4971,NA
JAL,Zapotlanejo,68519,33716,34803,6,3826,NA
JAL,San Ignacio Cerro Gordo,18952,9094,9858,23,1578,NA
MEX,Acambay de Ruíz Castañeda,66034,31875,34159,747,35538,NA
MEX,Acolman,152506,74567,77939,2440,22833,Valle de México
MEX,Aculco,49026,24023,25003,339,27136,NA
MEX,Almoloya de Alquisiras,14846,7122,7724,28,697,NA
MEX,Almoloya de Juárez,176237,86702,89535,1642,14428,Toluca
MEX,Almoloya del Río,11126,5357,5769,67,826,Tianguistenco
MEX,Amanalco,24669,11918,12751,654,16479,NA
MEX,Amatepec,26610,12864,13746,39,142,NA
MEX,Amecameca,50904,24585,26319,967,5682,Valle de México
MEX,Apaxco,29347,14289,15058,545,2989,Valle de México
MEX,Atenco,62392,30141,32251,835,9328,Valle de México
MEX,Atizapán,11875,5707,6168,11,690,Tianguistenco
MEX,Atizapán de Zaragoza,523296,250724,272572,5410,32649,Valle de México
MEX,Atlacomulco,100675,48020,52655,405,54144,NA
MEX,Atlautla,30945,15138,15807,563,3536,Valle de México
MEX,Axapusco,27709,13606,14103,292,1765,Valle de México
MEX,Ayapango,9863,4782,5081,361,1322,Valle de México
MEX,Calimaya,56574,27542,29032,1443,5212,Toluca
MEX,Capulhuac,35495,17091,18404,256,2879,Tianguistenco
MEX,Coacalco de Berriozábal,284462,135359,149103,3789,16945,Valle de México
MEX,Coatepec Harinas,39897,19237,20660,408,4013,NA
MEX,Cocotitlán,14414,6934,7480,173,2179,Valle de México
MEX,Coyotepec,41810,20412,21398,575,4403,Valle de México
MEX,Cuautitlán,149550,72925,76625,1324,11630,Valle de México
MEX,Chalco,343701,167373,176328,12040,51184,Valle de México
MEX,Chapa de Mota,28289,13702,14587,1460,16764,NA
MEX,Chapultepec,11764,5745,6019,163,908,Toluca
MEX,Chiautla,29159,14319,14840,1476,4311,Valle de México
MEX,Chicoloapan,204107,97261,106846,5687,26125,Valle de México
MEX,Chiconcuac,25543,12640,12903,254,3087,Valle de México
MEX,Chimalhuacán,679811,331766,348045,26154,111131,Valle de México
MEX,Donato Guerra,34000,16544,17456,134,18391,NA
MEX,Ecatepec de Morelos,1677678,814477,863201,30411,169100,Valle de México
MEX,Ecatzingo,9414,4610,4804,48,1460,Valle de México
MEX,Huehuetoca,128486,63108,65378,2050,13880,Valle de México
MEX,Hueypoxtla,43784,21927,21857,269,4833,Valle de México
MEX,Huixquilucan,267858,127486,140372,4972,48804,Valle de México
MEX,Isidro Fabela,11726,5804,5922,322,3407,Valle de México
MEX,Ixtapaluca,495563,242723,252840,11876,71358,Valle de México
MEX,Ixtapan de la Sal,35552,17078,18474,166,1912,NA
MEX,Ixtapan del Oro,6791,3426,3365,5,2725,NA
MEX,Ixtlahuaca,153184,73286,79898,546,93267,NA
MEX,Xalatlaco,29572,14280,15292,602,9721,Tianguistenco
MEX,Jaltenco,27825,13384,14441,758,4983,Valle de México
MEX,Jilotepec,87927,42745,45182,639,17259,NA
MEX,Jilotzingo,19013,9179,9834,70,1658,Valle de México
MEX,Jiquipilco,74314,35837,38477,707,41303,NA
MEX,Jocotitlán,65291,31317,33974,3629,31683,NA
MEX,Joquicingo,13857,6786,7071,274,1914,NA
MEX,Juchitepec,25436,12406,13030,2626,6725,Valle de México
MEX,Lerma,146654,71085,75569,2399,50045,Toluca
MEX,Malinalco,27482,13417,14065,138,2617,NA
MEX,Melchor Ocampo,57152,27761,29391,398,5714,Valle de México
MEX,Metepec,227827,110495,117332,1986,13318,Toluca
MEX,Mexicaltzingo,12796,6136,6660,136,1294,Toluca
MEX,Morelos,29862,14328,15534,2301,24424,NA
MEX,Naucalpan de Juárez,844219,407294,436925,14831,88651,Valle de México
MEX,Nezahualcóyotl,1039867,497348,542519,15296,111843,Valle de México
MEX,Nextlalpan,39666,19559,20107,633,5862,Valle de México
MEX,Nicolás Romero,410118,197904,212214,10598,67944,Valle de México
MEX,Nopaltepec,8960,4388,4572,103,249,Valle de México
MEX,Ocoyoacac,66190,32206,33984,243,15664,Toluca
MEX,Ocuilan,34485,16716,17769,564,10819,NA
MEX,El Oro,37343,17913,19430,85,22556,NA
MEX,Otumba,35274,17421,17853,1559,4430,Valle de México
MEX,Otzoloapan,3872,1947,1925,4,89,NA
MEX,Otzolotepec,84519,41427,43092,983,41598,Toluca
MEX,Ozumba,29114,13920,15194,94,3448,Valle de México
MEX,Papalotla,3963,1917,2046,52,357,Valle de México
MEX,La Paz,293725,145033,148692,4529,59927,Valle de México
MEX,Polotitlán,13851,6707,7144,86,6312,NA
MEX,Rayón,13261,6469,6792,98,632,Toluca
MEX,San Antonio la Isla,27230,13307,13923,917,3742,Toluca
MEX,San Felipe del Progreso,134143,63833,70310,231,106760,NA
MEX,San Martín de las Pirámides,26960,13126,13834,339,1247,Valle de México
MEX,San Mateo Atenco,75511,36719,38792,1517,6826,Toluca
MEX,San Simón de Guerrero,6010,2916,3094,77,846,NA
MEX,Santo Tomás,9682,4781,4901,40,949,NA
MEX,Soyaniquilpan de Juárez,13290,6538,6752,137,4593,NA
MEX,Sultepec,26832,12660,14172,120,1781,NA
MEX,Tecámac,446008,216509,229499,6202,41458,Valle de México
MEX,Tejupilco,77799,37410,40389,168,3693,NA
MEX,Temamatla,12984,6277,6707,542,1801,Valle de México
MEX,Temascalapa,38622,19068,19554,2092,8320,Valle de México
MEX,Temascalcingo,63721,30177,33544,319,34944,NA
MEX,Temascaltepec,31631,15381,16250,20,4758,NA
MEX,Temoaya,103834,50017,53817,1874,80985,Toluca
MEX,Tenancingo,97891,47212,50679,274,13852,NA
MEX,Tenango del Aire,12470,6148,6322,362,1352,Valle de México
MEX,Tenango del Valle,86380,42014,44366,2056,22981,NA
MEX,Teoloyucan,66518,32545,33973,2181,12477,Valle de México
MEX,Teotihuacán,56993,27782,29211,1308,6048,Valle de México
MEX,Tepetlaoxtoc,30680,15108,15572,402,4815,Valle de México
MEX,Tepetlixpa,19843,9744,10099,100,2304,Valle de México
MEX,Tepotzotlán,94198,45533,48665,5596,16115,Valle de México
MEX,Tequixquiac,36902,18163,18739,162,3036,Valle de México
MEX,Texcaltitlán,19206,9286,9920,110,364,NA
MEX,Texcalyacac,5246,2563,2683,88,1013,Tianguistenco
MEX,Texcoco,240749,113917,126832,3854,44884,Valle de México
MEX,Tezoyuca,41333,20434,20899,790,3713,Valle de México
MEX,Tianguistenco,77147,37150,39997,455,21717,Tianguistenco
MEX,Timilpan,15664,7481,8183,148,6932,NA
MEX,Tlalmanalco,47390,22517,24873,658,6915,Valle de México
MEX,Tlalnepantla de Baz,700734,337076,363658,16443,85805,Valle de México
MEX,Tlatlaya,34937,17145,17792,166,6707,NA
MEX,Toluca,873536,418527,455009,10035,181380,Toluca
MEX,Tonatico,12324,5977,6347,172,440,NA
MEX,Tultepec,150182,73168,77014,5532,18872,Valle de México
MEX,Tultitlán,520557,252955,267602,13439,61899,Valle de México
MEX,Valle de Bravo,65703,31980,33723,481,6470,NA
MEX,Villa de Allende,52641,25596,27045,217,26534,NA
MEX,Villa del Carbón,47151,23467,23684,582,17093,Valle de México
MEX,Villa Guerrero,67929,33341,34588,311,3114,NA
MEX,Villa Victoria,104612,51563,53049,396,35160,NA
MEX,Xonacatlán,51646,25984,25662,471,17253,Toluca
MEX,Zacazonapan,4137,2053,2084,561,555,NA
MEX,Zacualpan,14958,7138,7820,20,1036,NA
MEX,Zinacantepec,188927,92503,96424,5410,43671,Toluca
MEX,Zumpahuacán,16927,8069,8858,47,1125,NA
MEX,Zumpango,199069,96154,102915,1393,16298,Valle de México
MEX,Cuautitlán Izcalli,531041,257040,274001,13258,41084,Valle de México
MEX,Valle de Chalco Solidaridad,396157,191794,204363,13585,55667,Valle de México
MEX,Luvianos,27860,13680,14180,72,916,NA
MEX,San José del Rincón,93878,46261,47617,512,84178,NA
MEX,Tonanitla,9728,4761,4967,265,2063,Valle de México
MICH,Acuitzio,11425,5457,5968,0,755,NA
MICH,Aguililla,15241,7600,7641,10,1909,NA
MICH,Álvaro Obregón,21651,10508,11143,5,3015,NA
MICH,Angamacutiro,15193,7256,7937,1,3743,NA
MICH,Angangueo,11120,5366,5754,2,2044,NA
MICH,Apatzingán,128250,62961,65289,91,15971,NA
MICH,Aporo,3218,1559,1659,0,617,NA
MICH,Aquila,24864,12376,12488,0,19360,NA
MICH,Ario,36549,17564,18985,3,4273,NA
MICH,Arteaga,22138,10829,11309,0,3310,NA
MICH,Briseñas,11328,5529,5799,4,3802,NA
MICH,Buenavista,47498,24172,23326,44,10165,NA
MICH,Carácuaro,9485,4713,4772,146,1370,NA
MICH,Coahuayana,14392,7440,6952,289,5002,NA
MICH,Coalcomán de Vázquez Pallares,18444,9151,9293,2,1564,NA
MICH,Coeneo,20749,9705,11044,2,10893,NA
MICH,Contepec,34193,16520,17673,0,8297,NA
MICH,Copándaro,9151,4350,4801,0,3304,NA
MICH,Cotija,19018,9055,9963,2,3344,NA
MICH,Cuitzeo,29681,14168,15513,5,5871,NA
MICH,Charapan,12373,5808,6565,0,11402,NA
MICH,Charo,21784,10656,11128,0,5137,Morelia
MICH,Chavinda,10258,4957,5301,1,2484,NA
MICH,Cherán,19081,9064,10017,0,18086,NA
MICH,Chilchota,39035,18591,20444,0,35174,NA
MICH,Chinicuila,5032,2638,2394,0,1095,NA
MICH,Chucándiro,4559,2177,2382,0,1463,NA
MICH,Churintzio,5016,2366,2650,0,980,NA
MICH,Churumuco,15455,7665,7790,15,3755,NA
MICH,Ecuandureo,12788,5932,6856,0,889,NA
MICH,Epitacio Huerta,16622,8180,8442,5,1815,NA
MICH,Erongarícuaro,15291,7295,7996,2,12547,NA
MICH,Gabriel Zamora,22707,11271,11436,2,4959,NA
MICH,Hidalgo,122619,59644,62975,67,28535,NA
MICH,La Huacana,34243,16950,17293,108,6209,NA
MICH,Huandacareo,11723,5455,6268,0,1573,NA
MICH,Huaniqueo,8093,3795,4298,0,2095,NA
MICH,Huetamo,40818,19625,21193,140,4010,NA
MICH,Huiramba,8838,4278,4560,0,2275,NA
MICH,Indaparapeo,16990,8300,8690,2,5876,NA
MICH,Irimbo,15215,7264,7951,18,2130,NA
MICH,Ixtlán,12720,6299,6421,0,336,NA
MICH,Jacona,69744,33585,36159,0,16527,Zamora-Jacona
MICH,Jiménez,12426,5979,6447,2,4911,NA
MICH,Jiquilpan,32950,15718,17232,12,8083,NA
MICH,Juárez,14387,6983,7404,2,2002,NA
MICH,Jungapeo,21548,10725,10823,4,2759,NA
MICH,Lagunillas,5571,2751,2820,0,388,NA
MICH,Madero,18030,9109,8921,10,2315,NA
MICH,Maravatío,88535,42435,46100,12,17264,NA
MICH,Marcos Castellanos,13750,6570,7180,2,3287,NA
MICH,Lázaro Cárdenas,183185,90448,92737,572,28612,NA
MICH,Morelia,784776,372358,412418,444,139180,Morelia
MICH,Morelos,7806,3637,4169,2,2381,NA
MICH,Múgica,45484,22208,23276,92,17744,NA
MICH,Nahuatzen,28074,13517,14557,3,26069,NA
MICH,Nocupétaro,8195,4062,4133,138,2662,NA
MICH,Nuevo Parangaricutiro,19595,9619,9976,0,16354,NA
MICH,Nuevo Urecho,7988,3950,4038,7,1629,NA
MICH,Numarán,9794,4640,5154,0,526,NA
MICH,Ocampo,24424,12047,12377,0,10144,NA
MICH,Pajacuarán,19440,9252,10188,8,4189,NA
MICH,Panindícuaro,15705,7413,8292,4,5770,NA
MICH,Parácuaro,26789,13487,13302,6,3175,NA
MICH,Paracho,37464,17852,19612,12,32012,NA
MICH,Pátzcuaro,93265,44529,48736,47,59766,NA
MICH,Penjamillo,16920,7899,9021,7,2895,NA
MICH,Peribán,27832,13919,13913,23,17922,NA
MICH,La Piedad,103702,49155,54547,61,11440,La Piedad-Pénjamo
MICH,Purépero,15255,7416,7839,0,4257,NA
MICH,Puruándiro,67644,32150,35494,12,16810,NA
MICH,Queréndaro,13836,6770,7066,0,1900,NA
MICH,Quiroga,27862,13253,14609,9,16825,NA
MICH,Cojumatlán de Régules,10450,5101,5349,0,2272,NA
MICH,Los Reyes,69723,33590,36133,29,26020,NA
MICH,Sahuayo,76587,37188,39399,43,13878,NA
MICH,San Lucas,17845,8856,8989,18,824,NA
MICH,Santa Ana Maya,12466,5912,6554,0,2102,NA
MICH,Salvador Escalante,49588,24017,25571,0,25988,NA
MICH,Senguio,19146,9250,9896,7,4309,NA
MICH,Susupuato,8804,4351,4453,2,3639,NA
MICH,Tacámbaro,76661,37264,39397,101,15286,NA
MICH,Tancítaro,31100,15680,15420,0,10611,NA
MICH,Tangamandapio,29268,14214,15054,18,15961,NA
MICH,Tangancícuaro,33621,16270,17351,192,22035,NA
MICH,Tanhuato,15352,7458,7894,0,479,NA
MICH,Taretan,14819,7307,7512,7,4821,NA
MICH,Tarímbaro,105400,50527,54873,88,14051,Morelia
MICH,Tepalcatepec,23842,11901,11941,9,10960,NA
MICH,Tingambato,15010,7221,7789,6,13635,NA
MICH,Tingüindín,14532,6964,7568,1,8447,NA
MICH,Tiquicheo de Nicolás Romero,13731,6671,7060,0,456,NA
MICH,Tlalpujahua,27788,13248,14540,26,4701,NA
MICH,Tlazazalca,6202,2990,3212,0,2152,NA
MICH,Tocumbo,11994,5934,6060,6,3630,NA
MICH,Tumbiscatío,6947,3522,3425,4,1197,NA
MICH,Turicato,31849,15632,16217,173,6359,NA
MICH,Tuxpan,27371,13135,14236,0,2950,NA
MICH,Tuzantla,15383,7643,7740,2,358,NA
MICH,Tzintzuntzan,14432,6856,7576,1,11600,NA
MICH,Tzitzio,8966,4506,4460,0,1885,NA
MICH,Uruapan,334749,160093,174656,354,119029,NA
MICH,Venustiano Carranza,24708,11957,12751,15,5935,NA
MICH,Villamar,17166,8341,8825,24,3599,NA
MICH,Vista Hermosa,20624,10033,10591,0,1092,NA
MICH,Yurécuaro,31404,15234,16170,18,954,NA
MICH,Zacapu,75632,36041,39591,38,32129,NA
MICH,Zamora,196208,94581,101627,63,49280,Zamora-Jacona
MICH,Zináparo,3200,1502,1698,0,372,NA
MICH,Zinapécuaro,47327,22628,24699,0,10948,NA
MICH,Ziracuaretiro,17394,8566,8828,0,10964,NA
MICH,Zitácuaro,164144,77086,87058,32,59048,NA
MICH,José Sixto Verduzco,26214,12552,13662,0,4121,NA
MOR,Amacuzac,17772,8692,9080,123,2998,NA
MOR,Atlatlahucan,22079,10814,11265,28,10237,Cuautla
MOR,Axochiapan,35689,17588,18101,16,9516,NA
MOR,Ayala,85521,40878,44643,312,24340,Cuautla
MOR,Coatlán del Río,9768,4777,4991,0,2424,NA
MOR,Cuautla,194786,93893,100893,434,45558,Cuautla
MOR,Cuernavaca,366321,169466,196855,1576,73841,Cuernavaca
MOR,Emiliano Zapata,99493,48658,50835,632,25349,Cuernavaca
MOR,Huitzilac,19231,9548,9683,99,9327,Cuernavaca
MOR,Jantetelco,17238,8372,8866,5,6182,NA
MOR,Jiutepec,214137,102901,111236,1302,54423,Cuernavaca
MOR,Jojutla,57121,27510,29611,194,12567,NA
MOR,Jonacatepec,15690,7498,8192,14,5040,NA
MOR,Mazatepec,9967,4887,5080,12,2230,NA
MOR,Miacatlán,26713,13004,13709,42,13588,NA
MOR,Ocuituco,18580,9136,9444,4,7501,NA
MOR,Puente de Ixtla,66435,32039,34396,433,25547,NA
MOR,Temixco,116143,56675,59468,981,35112,Cuernavaca
MOR,Tepalcingo,27187,13329,13858,9,9156,NA
MOR,Tepoztlán,46946,22923,24023,170,26071,Cuernavaca
MOR,Tetecala,7772,3897,3875,13,1447,NA
MOR,Tetela del Volcán,20698,10074,10624,28,9855,NA
MOR,Tlalnepantla,7166,3600,3566,8,3634,NA
MOR,Tlaltizapán de Zapata,52110,25132,26978,184,18537,Cuernavaca
MOR,Tlaquiltenango,33844,16477,17367,66,7920,NA
MOR,Tlayacapan,17714,8711,9003,130,8654,Cuautla
MOR,Totolapan,11992,5876,6116,8,8130,NA
MOR,Xochitepec,68984,33837,35147,401,17219,Cuernavaca
MOR,Yautepec,102690,49363,53327,342,29093,Cuautla
MOR,Yecapixtla,52651,25830,26821,213,17011,Cuautla
MOR,Zacatepec,36159,17185,18974,163,6322,NA
MOR,Zacualpan de Amilpas,9370,4550,4820,3,2700,NA
MOR,Temoac,15844,7786,8058,0,3720,NA
NAY,Acaponeta,37309,18630,18679,12,12595,NA
NAY,Ahuacatlán,15953,8043,7910,2,3838,NA
NAY,Amatlán de Cañas,11851,6052,5799,0,1145,NA
NAY,Compostela,75520,37562,37958,40,7252,NA
NAY,Huajicori,12614,6323,6291,0,11106,NA
NAY,Ixtlán del Río,29416,14266,15150,18,6656,NA
NAY,Jala,18580,9232,9348,0,6987,NA
NAY,Xalisco,57418,27856,29562,22,8555,Tepic
NAY,Del Nayar,42514,21219,21295,0,39902,NA
NAY,Rosamorada,33901,17378,16523,3,10769,NA
NAY,Ruíz,24743,12491,12252,0,7446,NA
NAY,San Blas,43979,22661,21318,37,9786,NA
NAY,San Pedro Lagunillas,7499,3840,3659,0,1440,NA
NAY,Santa María del Oro,23477,11798,11679,20,6654,NA
NAY,Santiago Ixcuintla,97820,49824,47996,45,18966,NA
NAY,Tecuala,39718,20152,19566,0,5462,NA
NAY,Tepic,413608,199571,214037,88,66486,Tepic
NAY,Tuxpan,30565,15206,15359,6,5781,NA
NAY,La Yesca,14315,7394,6921,0,6259,NA
NAY,Bahía de Banderas,150250,76502,73748,450,24922,Puerto Vallarta
NL,Abasolo,2639,1295,1344,1,42,NA
NL,Agualeguas,2439,1241,1198,0,19,NA
NL,Los Aldamas,1292,637,655,1,28,NA
NL,Allende,34353,17214,17139,3,585,NA
NL,Anáhuac,18194,8982,9212,0,547,NA
NL,Apodaca,597207,301529,295678,8077,42579,Monterrey
NL,Aramberri,16152,8077,8075,0,249,NA
NL,Bustamante,3977,1983,1994,0,69,NA
NL,Cadereyta Jiménez,95534,47620,47914,1304,2163,Monterrey
NL,El Carmen,38306,19300,19006,1292,3580,Monterrey
NL,Cerralvo,7757,3982,3775,8,348,NA
NL,Ciénega de Flores,42715,21713,21002,283,9051,NA
NL,China,10835,5498,5337,2,68,NA
NL,Doctor Arroyo,34110,17217,16893,0,3009,NA
NL,Doctor Coss,1632,814,818,0,32,NA
NL,Doctor González,2861,1457,1404,0,307,NA
NL,Galeana,41130,20625,20505,0,1154,NA
NL,García,247370,123915,123455,4987,32810,Monterrey
NL,San Pedro Garza García,123156,58208,64948,926,5846,Monterrey
NL,General Bravo,5479,2744,2735,6,213,NA
NL,General Escobedo,425148,211057,214091,31512,77065,Monterrey
NL,General Terán,14795,7325,7470,0,114,NA
NL,General Treviño,1044,498,546,0,6,NA
NL,General Zaragoza,6011,3092,2919,0,10,NA
NL,General Zuazua,67294,33586,33708,304,8097,NA
NL,Guadalupe,682880,336980,345900,11177,46081,Monterrey
NL,Los Herreras,1764,872,892,0,2,NA
NL,Higueras,1511,786,725,2,88,NA
NL,Hualahuises,6921,3425,3496,2,426,NA
NL,Iturbide,3571,1847,1724,0,6,NA
NL,Juárez,333481,168457,165024,2210,21482,Monterrey
NL,Lampazos de Naranjo,5238,2643,2595,0,248,NA
NL,Linares,79853,39813,40040,6,1960,NA
NL,Marín,5630,2907,2723,0,269,NA
NL,Melchor Ocampo,955,485,470,0,1,NA
NL,Mier y Noriega,6996,3534,3462,2,362,NA
NL,Mina,5326,2707,2619,0,83,NA
NL,Montemorelos,60829,30606,30223,18,386,NA
NL,Monterrey,1109171,545055,564116,8452,48533,Monterrey
NL,Parás,971,495,476,0,21,NA
NL,Pesquería,87168,43575,43593,529,11046,NA
NL,Los Ramones,4469,2244,2225,0,25,NA
NL,Rayones,2640,1348,1292,0,6,NA
NL,Sabinas Hidalgo,35456,17255,18201,8,2437,NA
NL,Salinas Victoria,54192,27678,26514,232,4458,Monterrey
NL,San Nicolás de los Garza,430143,209507,220636,2001,9123,Monterrey
NL,Hidalgo,13836,6950,6886,0,526,NA
NL,Santa Catarina,296954,148962,147992,2769,14647,Monterrey
NL,Santiago,42407,21219,21188,124,1396,Monterrey
NL,Vallecillo,1632,868,764,0,377,NA
NL,Villaldama,4080,2030,2050,3,302,NA
OAX,Abejones,882,370,512,72,855,NA
OAX,Acatlán de Pérez Figueroa,45883,22376,23507,1131,25382,NA
OAX,Asunción Cacalotepec,2027,984,1043,4,2018,NA
OAX,Asunción Cuyotepeji,930,437,493,44,578,NA
OAX,Asunción Ixtaltepec,15105,7485,7620,234,11397,NA
OAX,Asunción Nochixtlán,18525,8588,9937,224,13342,NA
OAX,Asunción Ocotlán,2550,1156,1394,3,2405,NA
OAX,Asunción Tlacolulita,758,366,392,2,721,NA
OAX,Ayotzintepec,7102,3506,3596,12,6319,NA
OAX,El Barrio de la Soledad,14277,6809,7468,901,7249,NA
OAX,Calihualá,1182,568,614,25,832,NA
OAX,Candelaria Loxicha,10497,5151,5346,21,8832,NA
OAX,Ciénega de Zimatlán,2953,1415,1538,86,558,NA
OAX,Ciudad Ixtepec,28637,13606,15031,813,19267,NA
OAX,Coatecas Altas,4823,2258,2565,530,3737,NA
OAX,Coicoyán de las Flores,9936,4672,5264,49,9775,NA
OAX,La Compañía,3365,1626,1739,218,1862,NA
OAX,Concepción Buenavista,803,397,406,0,506,NA
OAX,Concepción Pápalo,2934,1448,1486,124,2707,NA
OAX,Constancia del Rosario,3947,1821,2126,5,2702,NA
OAX,Cosolapa,15866,7538,8328,612,10770,NA
OAX,Cosoltepec,716,338,378,0,589,NA
OAX,Cuilápam de Guerrero,21597,10475,11122,195,9248,NA
OAX,Cuyamecalco Villa de Zaragoza,3643,1825,1818,34,3342,NA
OAX,Chahuites,11413,5626,5787,31,2032,NA
OAX,Chalcatongo de Hidalgo,9066,4256,4810,64,7989,NA
OAX,Chiquihuitlán de Benito Juárez,2251,999,1252,7,2156,NA
OAX,Heroica Ciudad de Ejutla de Crespo,20915,9876,11039,226,8339,NA
OAX,Eloxochitlán de Flores Magón,4135,1930,2205,7,4069,NA
OAX,El Espinal,8575,4180,4395,58,5395,NA
OAX,Tamazulápam del Espíritu Santo,7102,3106,3996,56,6929,NA
OAX,Fresnillo de Trujano,996,485,511,50,896,NA
OAX,Guadalupe Etla,2637,1236,1401,67,1125,NA
OAX,Guadalupe de Ramírez,1172,563,609,15,475,NA
OAX,Guelatao de Juárez,531,254,277,22,482,NA
OAX,Guevea de Humboldt,5409,2589,2820,243,5231,NA
OAX,Mesones Hidalgo,4380,2033,2347,1571,3269,NA
OAX,Villa Hidalgo,1917,909,1008,7,1875,NA
OAX,Heroica Ciudad de Huajuapan de León,77547,36429,41118,4644,39825,NA
OAX,Huautepec,6299,2928,3371,26,6166,NA
OAX,Huautla de Jiménez,31551,14636,16915,1718,30683,NA
OAX,Ixtlán de Juárez,8268,4035,4233,26,7793,NA
OAX,Heroica Ciudad de Juchitán de Zaragoza,98043,47156,50887,1357,81385,NA
OAX,Loma Bonita,42884,20397,22487,518,7924,NA
OAX,Magdalena Apasco,8303,3933,4370,358,4590,NA
OAX,Magdalena Jaltepec,3149,1451,1698,18,2628,NA
OAX,Santa Magdalena Jicotlán,87,39,48,0,48,NA
OAX,Magdalena Mixtepec,1375,662,713,739,1292,NA
OAX,Magdalena Ocotlán,1146,554,592,12,894,NA
OAX,Magdalena Peñasco,3381,1565,1816,2,3337,NA
OAX,Magdalena Teitipac,4563,2227,2336,646,4491,NA
OAX,Magdalena Tequisistlán,6038,2931,3107,29,5260,NA
OAX,Magdalena Tlacotepec,1220,585,635,5,830,NA
OAX,Magdalena Zahuatlán,415,196,219,1,341,NA
OAX,Mariscala de Juárez,3486,1674,1812,357,1909,NA
OAX,Mártires de Tacubaya,1424,672,752,161,396,NA
OAX,Matías Romero Avendaño,39828,19259,20569,0,0,NA
OAX,Mazatlán Villa de Flores,13097,6456,6641,182,12853,NA
OAX,Miahuatlán de Porfirio Díaz,42312,19793,22519,2614,19771,NA
OAX,Mixistlán de la Reforma,2585,1220,1365,9,2567,NA
OAX,Monjas,2722,1256,1466,46,1936,NA
OAX,Natividad,475,211,264,1,465,NA
OAX,Nazareno Etla,3910,1867,2043,20,2373,NA
OAX,Nejapa de Madero,7385,3627,3758,46,4804,NA
OAX,Ixpantepec Nieves,1209,538,671,62,1141,NA
OAX,Santiago Niltepec,5327,2639,2688,588,2744,NA
OAX,Oaxaca de Juárez,264251,119946,144305,11875,105561,Oaxaca
OAX,Ocotlán de Morelos,21676,10306,11370,105,9506,NA
OAX,La Pe,2632,1275,1357,490,1591,NA
OAX,Pinotepa de Don Luis,6893,3379,3514,79,6425,NA
OAX,Pluma Hidalgo,2871,1382,1489,103,789,NA
OAX,San José del Progreso,6822,3297,3525,14,5498,NA
OAX,Putla Villa de Guerrero,32640,15250,17390,2342,17851,NA
OAX,Santa Catarina Quioquitani,482,240,242,2,475,NA
OAX,Reforma de Pineda,2723,1302,1421,6,2477,NA
OAX,La Reforma,3256,1566,1690,596,1908,NA
OAX,Reyes Etla,3757,1829,1928,38,2180,NA
OAX,Rojas de Cuauhtémoc,1095,510,585,14,561,NA
OAX,Salina Cruz,89211,42336,46875,1395,47492,Tehuantepec
OAX,San Agustín Amatengo,1459,694,765,4,1040,NA
OAX,San Agustín Atenango,1760,817,943,23,1691,NA
OAX,San Agustín Chayuco,4099,1976,2123,524,3708,NA
OAX,San Agustín de las Juntas,9342,4508,4834,703,5045,Oaxaca
OAX,San Agustín Etla,3984,1891,2093,167,1713,NA
OAX,San Agustín Loxicha,24467,11979,12488,937,23772,NA
OAX,San Agustín Tlacotepec,929,405,524,8,900,NA
OAX,San Agustín Yatareni,4334,2000,2334,31,2701,Oaxaca
OAX,San Andrés Cabecera Nueva,2819,1388,1431,117,1943,NA
OAX,San Andrés Dinicuiti,2112,1033,1079,12,977,NA
OAX,San Andrés Huaxpaltepec,6168,2963,3205,1137,4393,NA
OAX,San Andrés Huayápam,5336,2558,2778,36,2235,Oaxaca
OAX,San Andrés Ixtlahuaca,1604,759,845,2,1107,NA
OAX,San Andrés Lagunas,483,220,263,1,261,NA
OAX,San Andrés Nuxiño,1756,842,914,308,1695,NA
OAX,San Andrés Paxtlán,4295,2129,2166,44,4058,NA
OAX,San Andrés Sinaxtla,716,335,381,40,432,NA
OAX,San Andrés Solaga,1671,821,850,6,1652,NA
OAX,San Andrés Teotilálpam,4425,2102,2323,16,4307,NA
OAX,San Andrés Tepetlapa,472,227,245,5,318,NA
OAX,San Andrés Yaá,422,191,231,0,420,NA
OAX,San Andrés Zabache,739,335,404,9,694,NA
OAX,San Andrés Zautla,4409,2106,2303,107,3255,NA
OAX,San Antonino Castillo Velasco,6009,2849,3160,72,5256,NA
OAX,San Antonino el Alto,2606,1287,1319,91,2412,NA
OAX,San Antonino Monte Verde,7305,3332,3973,75,7088,NA
OAX,San Antonio Acutla,249,116,133,31,221,NA
OAX,San Antonio de la Cal,23038,10809,12229,486,9498,Oaxaca
OAX,San Antonio Huitepec,4421,2015,2406,372,4222,NA
OAX,San Antonio Nanahuatípam,1227,608,619,2,575,NA
OAX,San Antonio Sinicahua,1484,667,817,3,1463,NA
OAX,San Antonio Tepetlapa,4245,2033,2212,134,4058,NA
OAX,San Baltazar Chichicápam,2494,1174,1320,9,2440,NA
OAX,San Baltazar Loxicha,2996,1446,1550,292,2187,NA
OAX,San Baltazar Yatzachi el Bajo,641,303,338,5,626,NA
OAX,San Bartolo Coyotepec,9105,4309,4796,485,4819,Oaxaca
OAX,San Bartolomé Ayautla,4415,2117,2298,58,4367,NA
OAX,San Bartolomé Loxicha,2337,1146,1191,19,2303,NA
OAX,San Bartolomé Quialana,2476,1030,1446,8,2383,NA
OAX,San Bartolomé Yucuañe,386,164,222,0,374,NA
OAX,San Bartolomé Zoogocho,334,143,191,0,329,NA
OAX,San Bartolo Soyaltepec,654,296,358,3,607,NA
OAX,San Bartolo Yautepec,636,318,318,0,620,NA
OAX,San Bernardo Mixtepec,2741,1313,1428,29,1885,NA
OAX,San Blas Atempa,18406,9153,9253,70,15596,Tehuantepec
OAX,San Carlos Yautepec,12101,6083,6018,23,10622,NA
OAX,San Cristóbal Amatlán,5148,2402,2746,130,5029,NA
OAX,San Cristóbal Amoltepec,1004,442,562,9,980,NA
OAX,San Cristóbal Lachirioag,1206,586,620,4,1186,NA
OAX,San Cristóbal Suchixtlahuaca,360,179,181,0,233,NA
OAX,San Dionisio del Mar,5127,2605,2522,70,4701,NA
OAX,San Dionisio Ocotepec,10628,4961,5667,63,10108,NA
OAX,San Dionisio Ocotlán,1077,522,555,0,543,NA
OAX,San Esteban Atatlahuca,3596,1746,1850,67,3554,NA
OAX,San Felipe Jalapa de Díaz,27979,13245,14734,351,27188,NA
OAX,San Felipe Tejalápam,7862,3715,4147,117,5963,NA
OAX,San Felipe Usila,11604,5519,6085,19,11466,NA
OAX,San Francisco Cahuacuá,3379,1679,1700,315,3018,NA
OAX,San Francisco Cajonos,440,213,227,0,427,NA
OAX,San Francisco Chapulapa,2045,981,1064,16,1841,NA
OAX,San Francisco Chindúa,791,399,392,0,0,NA
OAX,San Francisco del Mar,7650,3826,3824,276,7423,NA
OAX,San Francisco Huehuetlán,991,446,545,26,963,NA
OAX,San Francisco Ixhuatán,8980,4448,4532,43,8234,NA
OAX,San Francisco Jaltepetongo,949,462,487,5,927,NA
OAX,San Francisco Lachigoló,3854,1857,1997,345,2483,NA
OAX,San Francisco Logueche,2787,1311,1476,1,2743,NA
OAX,San Francisco Nuxaño,367,188,179,0,263,NA
OAX,San Francisco Ozolotepec,1940,947,993,228,1852,NA
OAX,San Francisco Sola,1731,811,920,37,765,NA
OAX,San Francisco Telixtlahuaca,12894,6153,6741,534,8148,NA
OAX,San Francisco Teopan,323,171,152,6,221,NA
OAX,San Francisco Tlapancingo,2109,932,1177,2,1489,NA
OAX,San Gabriel Mixtepec,4836,2355,2481,1303,3155,NA
OAX,San Ildefonso Amatlán,2407,1120,1287,79,1998,NA
OAX,San Ildefonso Sola,985,496,489,0,711,NA
OAX,San Ildefonso Villa Alta,3316,1599,1717,17,3090,NA
OAX,San Jacinto Amilpas,15720,7473,8247,1161,7548,Oaxaca
OAX,San Jacinto Tlacotepec,2258,1086,1172,47,2132,NA
OAX,San Jerónimo Coatlán,5019,2430,2589,28,3250,NA
OAX,San Jerónimo Silacayoapilla,1391,682,709,66,1035,NA
OAX,San Jerónimo Sosola,2517,1185,1332,578,2032,NA
OAX,San Jerónimo Taviche,1934,933,1001,0,1382,NA
OAX,San Jerónimo Tecóatl,1590,735,855,9,1534,NA
OAX,San Jorge Nuchita,2772,1253,1519,2,1796,NA
OAX,San José Ayuquila,1512,699,813,12,1024,NA
OAX,San José Chiltepec,12098,5899,6199,126,8577,NA
OAX,San José del Peñasco,2035,988,1047,5,1408,NA
OAX,San José Estancia Grande,1059,528,531,413,525,NA
OAX,San José Independencia,3867,1861,2006,25,3836,NA
OAX,San José Lachiguiri,3251,1459,1792,10,3186,NA
OAX,San José Tenango,18316,8687,9629,244,18058,NA
OAX,San Juan Achiutla,376,185,191,13,310,NA
OAX,San Juan Atepec,1462,687,775,13,1406,NA
OAX,Ánimas Trujano,3917,1834,2083,973,2120,Oaxaca
OAX,San Juan Bautista Atatlahuca,1583,764,819,9,1392,NA
OAX,San Juan Bautista Coixtlahuaca,2687,1276,1411,27,1765,NA
OAX,San Juan Bautista Cuicatlán,9945,4772,5173,404,6566,NA
OAX,San Juan Bautista Guelache,6874,3253,3621,201,2752,NA
OAX,San Juan Bautista Jayacatlán,1456,729,727,9,874,NA
OAX,San Juan Bautista Lo de Soto,2593,1291,1302,1770,836,NA
OAX,San Juan Bautista Suchitepec,440,207,233,3,323,NA
OAX,San Juan Bautista Tlacoatzintepec,2178,1020,1158,2,1813,NA
OAX,San Juan Bautista Tlachichilco,1383,629,754,1,1120,NA
OAX,San Juan Bautista Tuxtepec,162511,76949,85562,4447,77417,NA
OAX,San Juan Cacahuatepec,8855,4307,4548,453,2657,NA
OAX,San Juan Cieneguilla,547,256,291,0,357,NA
OAX,San Juan Coatzóspam,1808,879,929,12,1756,NA
OAX,San Juan Colorado,10030,4844,5186,699,8875,NA
OAX,San Juan Comaltepec,2870,1406,1464,42,2807,NA
OAX,San Juan Cotzocón,23686,11398,12288,214,19383,NA
OAX,San Juan Chicomezúchil,330,150,180,1,311,NA
OAX,San Juan Chilateca,1494,686,808,6,750,NA
OAX,San Juan del Estado,2592,1246,1346,132,1662,NA
OAX,San Juan del Río,1237,567,670,6,1131,NA
OAX,San Juan Diuxi,1071,524,547,6,1053,NA
OAX,San Juan Evangelista Analco,413,196,217,0,384,NA
OAX,San Juan Guelavía,3212,1539,1673,7,2704,NA
OAX,San Juan Guichicovi,29364,13789,15575,88,27773,NA
OAX,San Juan Ihualtepec,580,272,308,0,497,NA
OAX,San Juan Juquila Mixes,3726,1770,1956,8,3681,NA
OAX,San Juan Juquila Vijanos,1953,931,1022,1,1941,NA
OAX,San Juan Lachao,4677,2255,2422,1573,4150,NA
OAX,San Juan Lachigalla,3277,1550,1727,37,1368,NA
OAX,San Juan Lajarcia,607,270,337,0,279,NA
OAX,San Juan Lalana,16972,8257,8715,301,15807,NA
OAX,San Juan de los Cués,2444,1198,1246,295,1943,NA
OAX,San Juan Mazatlán,19163,9470,9693,47,14815,NA
OAX,San Juan Mixtepec,6680,3113,3567,209,6556,NA
OAX,San Juan Mixtepec,660,285,375,212,647,NA
OAX,San Juan Ñumí,5747,2564,3183,60,5631,NA
OAX,San Juan Ozolotepec,2664,1326,1338,221,2005,NA
OAX,San Juan Petlapa,2919,1405,1514,25,2877,NA
OAX,San Juan Quiahije,4286,1991,2295,81,4092,NA
OAX,San Juan Quiotepec,1979,960,1019,5,1932,NA
OAX,San Juan Sayultepec,788,358,430,0,638,NA
OAX,San Juan Tabaá,1280,606,674,3,1268,NA
OAX,San Juan Tamazola,2877,1393,1484,68,2735,NA
OAX,San Juan Teita,531,262,269,44,524,NA
OAX,San Juan Teitipac,2619,1249,1370,13,2486,NA
OAX,San Juan Tepeuxila,2639,1338,1301,289,2469,NA
OAX,San Juan Teposcolula,1228,604,624,9,964,NA
OAX,San Juan Yaeé,1481,697,784,7,1456,NA
OAX,San Juan Yatzona,474,206,268,2,468,NA
OAX,San Juan Yucuita,567,260,307,8,425,NA
OAX,San Lorenzo,6101,2919,3182,432,5733,NA
OAX,San Lorenzo Albarradas,2723,1381,1342,194,2269,NA
OAX,San Lorenzo Cacaotepec,15735,7478,8257,629,8085,Oaxaca
OAX,San Lorenzo Cuaunecuiltitla,807,422,385,19,769,NA
OAX,San Lorenzo Texmelúcan,8323,3861,4462,34,8161,NA
OAX,San Lorenzo Victoria,942,470,472,13,781,NA
OAX,San Lucas Camotlán,2961,1421,1540,11,2937,NA
OAX,San Lucas Ojitlán,20085,9618,10467,657,19335,NA
OAX,San Lucas Quiaviní,1736,727,1009,18,1699,NA
OAX,San Lucas Zoquiápam,7250,3503,3747,27,7034,NA
OAX,San Luis Amatlán,3642,1673,1969,155,1751,NA
OAX,San Marcial Ozolotepec,1557,736,821,105,1513,NA
OAX,San Marcos Arteaga,1422,663,759,21,733,NA
OAX,San Martín de los Cansecos,851,420,431,0,376,NA
OAX,San Martín Huamelúlpam,1010,471,539,33,886,NA
OAX,San Martín Itunyoso,2298,1028,1270,13,2267,NA
OAX,San Martín Lachilá,1087,488,599,62,842,NA
OAX,San Martín Peras,12246,5841,6405,65,11758,NA
OAX,San Martín Tilcajete,1821,823,998,10,1714,NA
OAX,San Martín Toxpalan,3787,1832,1955,153,2519,NA
OAX,San Martín Zacatepec,1265,630,635,404,731,NA
OAX,San Mateo Cajonos,616,285,331,3,607,NA
OAX,Capulálpam de Méndez,1549,687,862,6,1392,NA
OAX,San Mateo del Mar,14835,7484,7351,49,14667,NA
OAX,San Mateo Yoloxochitlán,3614,1697,1917,12,3442,NA
OAX,San Mateo Etlatongo,1107,540,567,73,415,NA
OAX,San Mateo Nejápam,1144,541,603,0,882,NA
OAX,San Mateo Peñasco,2062,962,1100,15,2040,NA
OAX,San Mateo Piñas,2084,1036,1048,137,986,NA
OAX,San Mateo Río Hondo,3133,1526,1607,114,2454,NA
OAX,San Mateo Sindihui,2019,944,1075,68,1771,NA
OAX,San Mateo Tlapiltepec,224,105,119,2,156,NA
OAX,San Melchor Betaza,986,459,527,2,975,NA
OAX,San Miguel Achiutla,712,345,367,8,640,NA
OAX,San Miguel Ahuehuetitlán,2360,1119,1241,6,1823,NA
OAX,San Miguel Aloápam,2172,1000,1172,179,2140,NA
OAX,San Miguel Amatitlán,7549,3539,4010,1269,5458,NA
OAX,San Miguel Amatlán,993,480,513,47,936,NA
OAX,San Miguel Coatlán,3178,1482,1696,34,2454,NA
OAX,San Miguel Chicahua,2097,947,1150,7,2066,NA
OAX,San Miguel Chimalapa,6817,3458,3359,437,5528,NA
OAX,San Miguel del Puerto,8362,4088,4274,17,5641,NA
OAX,San Miguel del Río,244,123,121,68,230,NA
OAX,San Miguel Ejutla,1014,470,544,56,467,NA
OAX,San Miguel el Grande,4109,1913,2196,112,3888,NA
OAX,San Miguel Huautla,1094,499,595,0,1053,NA
OAX,San Miguel Mixtepec,2644,1295,1349,5,2600,NA
OAX,San Miguel Panixtlahuaca,6422,2828,3594,693,6306,NA
OAX,San Miguel Peras,3287,1575,1712,42,3125,NA
OAX,San Miguel Piedras,1271,605,666,42,1151,NA
OAX,San Miguel Quetzaltepec,8119,4027,4092,25,7993,NA
OAX,San Miguel Santa Flor,702,356,346,0,674,NA
OAX,Villa Sola de Vega,12425,6103,6322,33,4727,NA
OAX,San Miguel Soyaltepec,39680,19041,20639,661,34167,NA
OAX,San Miguel Suchixtepec,2665,1232,1433,423,2446,NA
OAX,Villa Talea de Castro,2279,1087,1192,1,2254,NA
OAX,San Miguel Tecomatlán,266,138,128,15,185,NA
OAX,San Miguel Tenango,729,365,364,1,714,NA
OAX,San Miguel Tequixtepec,997,471,526,0,673,NA
OAX,San Miguel Tilquiápam,3149,1391,1758,9,3073,NA
OAX,San Miguel Tlacamama,3662,1798,1864,864,2325,NA
OAX,San Miguel Tlacotepec,3164,1485,1679,44,2941,NA
OAX,San Miguel Tulancingo,296,123,173,0,108,NA
OAX,San Miguel Yotao,593,273,320,3,592,NA
OAX,San Nicolás,1135,517,618,6,536,NA
OAX,San Nicolás Hidalgo,975,452,523,18,288,NA
OAX,San Pablo Coatlán,4245,2066,2179,4,2970,NA
OAX,San Pablo Cuatro Venados,1411,658,753,4,893,NA
OAX,San Pablo Etla,15993,7520,8473,577,4892,Oaxaca
OAX,San Pablo Huitzo,7024,3245,3779,610,4012,NA
OAX,San Pablo Huixtepec,9313,4435,4878,297,4744,NA
OAX,San Pablo Macuiltianguis,890,447,443,9,868,NA
OAX,San Pablo Tijaltepec,2504,1166,1338,2,2485,NA
OAX,San Pablo Villa de Mitla,12511,5955,6556,505,9312,NA
OAX,San Pablo Yaganiza,1063,503,560,5,1037,NA
OAX,San Pedro Amuzgos,6664,3059,3605,168,5833,NA
OAX,San Pedro Apóstol,1505,704,801,1,868,NA
OAX,San Pedro Atoyac,4539,2117,2422,68,3729,NA
OAX,San Pedro Cajonos,1089,507,582,3,1070,NA
OAX,San Pedro Coxcaltepec Cántaros,735,352,383,5,661,NA
OAX,San Pedro Comitancillo,4234,2020,2214,58,3384,NA
OAX,San Pedro el Alto,3551,1699,1852,351,3320,NA
OAX,San Pedro Huamelula,10014,4940,5074,169,8261,NA
OAX,San Pedro Huilotepec,3146,1546,1600,19,2903,NA
OAX,San Pedro Ixcatlán,11653,5590,6063,37,11268,NA
OAX,San Pedro Ixtlahuaca,8561,4147,4414,203,3896,NA
OAX,San Pedro Jaltepetongo,545,258,287,1,531,NA
OAX,San Pedro Jicayán,12387,5806,6581,1199,12052,NA
OAX,San Pedro Jocotipac,779,358,421,6,749,NA
OAX,San Pedro Juchatengo,1561,737,824,1,791,NA
OAX,San Pedro Mártir,1694,770,924,2,1638,NA
OAX,San Pedro Mártir Quiechapa,693,337,356,3,596,NA
OAX,San Pedro Mártir Yucuxaco,1239,560,679,2,1142,NA
OAX,San Pedro Mixtepec,48336,23381,24955,2463,16749,NA
OAX,San Pedro Mixtepec,1074,523,551,23,1039,NA
OAX,San Pedro Molinos,668,327,341,7,632,NA
OAX,San Pedro Nopala,720,342,378,12,502,NA
OAX,San Pedro Ocopetatillo,790,365,425,1,766,NA
OAX,San Pedro Ocotepec,2098,1001,1097,26,2078,NA
OAX,San Pedro Pochutla,47476,23090,24386,972,14920,NA
OAX,San Pedro Quiatoni,10810,5199,5611,28,10506,NA
OAX,San Pedro Sochiápam,5134,2511,2623,3,5073,NA
OAX,San Pedro Tapanatepec,15152,7469,7683,382,3783,NA
OAX,San Pedro Taviche,1208,598,610,1,1,NA
OAX,San Pedro Teozacoalco,1225,597,628,33,997,NA
OAX,San Pedro Teutila,4232,2062,2170,20,3654,NA
OAX,San Pedro Tidaá,873,407,466,0,798,NA
OAX,San Pedro Topiltepec,343,162,181,0,306,NA
OAX,San Pedro Totolápam,2626,1254,1372,12,266,NA
OAX,Villa de Tututepec de Melchor Ocampo,46152,22530,23622,17834,32477,NA
OAX,San Pedro Yaneri,910,434,476,0,904,NA
OAX,San Pedro Yólox,1698,825,873,2,1671,NA
OAX,San Pedro y San Pablo Ayutla,4813,2220,2593,62,4684,NA
OAX,Villa de Etla,10737,5020,5717,267,5808,Oaxaca
OAX,San Pedro y San Pablo Teposcolula,4016,1872,2144,356,2421,NA
OAX,San Pedro y San Pablo Tequixtepec,1680,759,921,208,1354,NA
OAX,San Pedro Yucunama,236,102,134,10,191,NA
OAX,San Raymundo Jalpan,3336,1514,1822,107,2041,NA
OAX,San Sebastián Abasolo,1933,925,1008,3,1139,NA
OAX,San Sebastián Coatlán,2678,1280,1398,8,2062,NA
OAX,San Sebastián Ixcapa,4072,1992,2080,1259,1987,NA
OAX,San Sebastián Nicananduta,1441,625,816,0,1124,NA
OAX,San Sebastián Río Hondo,3587,1750,1837,6,2909,NA
OAX,San Sebastián Tecomaxtlahuaca,8352,3929,4423,104,7554,NA
OAX,San Sebastián Teitipac,1967,889,1078,4,1811,NA
OAX,San Sebastián Tutla,18195,8340,9855,1022,8350,Oaxaca
OAX,San Simón Almolongas,2820,1318,1502,41,1545,NA
OAX,San Simón Zahuatlán,3526,1743,1783,799,3431,NA
OAX,Santa Ana,2153,1059,1094,1,1434,NA
OAX,Santa Ana Ateixtlahuaca,516,263,253,0,510,NA
OAX,Santa Ana Cuauhtémoc,727,358,369,0,703,NA
OAX,Santa Ana del Valle,2067,1014,1053,3,1948,NA
OAX,Santa Ana Tavela,762,359,403,8,229,NA
OAX,Santa Ana Tlapacoyan,1950,945,1005,734,1454,NA
OAX,Santa Ana Yareni,918,445,473,0,908,NA
OAX,Santa Ana Zegache,3773,1776,1997,11,3143,NA
OAX,Santa Catalina Quierí,871,386,485,12,867,NA
OAX,Santa Catarina Cuixtla,1427,630,797,54,924,NA
OAX,Santa Catarina Ixtepeji,2572,1226,1346,4,2310,NA
OAX,Santa Catarina Juquila,15987,7619,8368,868,12048,NA
OAX,Santa Catarina Lachatao,1068,509,559,76,1017,NA
OAX,Santa Catarina Loxicha,3905,1880,2025,32,3237,NA
OAX,Santa Catarina Mechoacán,4460,2188,2272,898,4356,NA
OAX,Santa Catarina Minas,1930,953,977,1,1017,NA
OAX,Santa Catarina Quiané,1931,948,983,34,581,NA
OAX,Santa Catarina Tayata,663,304,359,2,539,NA
OAX,Santa Catarina Ticuá,1031,469,562,2,956,NA
OAX,Santa Catarina Yosonotú,1556,709,847,11,1521,NA
OAX,Santa Catarina Zapoquila,366,171,195,1,278,NA
OAX,Santa Cruz Acatepec,1548,728,820,1,1535,NA
OAX,Santa Cruz Amilpas,12814,5939,6875,842,6796,Oaxaca
OAX,Santa Cruz de Bravo,356,168,188,0,179,NA
OAX,Santa Cruz Itundujia,11616,5500,6116,186,9566,NA
OAX,Santa Cruz Mixtepec,3425,1624,1801,291,2767,NA
OAX,Santa Cruz Nundaco,2921,1343,1578,368,2858,NA
OAX,Santa Cruz Papalutla,2127,1036,1091,8,1901,NA
OAX,Santa Cruz Tacache de Mina,2675,1282,1393,26,1702,NA
OAX,Santa Cruz Tacahua,1116,524,592,4,1068,NA
OAX,Santa Cruz Tayata,583,285,298,8,523,NA
OAX,Santa Cruz Xitla,4754,2258,2496,224,4330,NA
OAX,Santa Cruz Xoxocotlán,93188,43478,49710,4766,42700,Oaxaca
OAX,Santa Cruz Zenzontepec,18512,8987,9525,2946,17771,NA
OAX,Santa Gertrudis,2914,1416,1498,12,1279,NA
OAX,Santa Inés del Monte,2372,1154,1218,3,1556,NA
OAX,Santa Inés Yatzeche,952,418,534,107,880,NA
OAX,Santa Lucía del Camino,49459,23225,26234,2042,22708,Oaxaca
OAX,Santa Lucía Miahuatlán,3361,1622,1739,148,3223,NA
OAX,Santa Lucía Monteverde,6398,3058,3340,1328,6103,NA
OAX,Santa Lucía Ocotlán,3855,1801,2054,691,3639,NA
OAX,Santa María Alotepec,2766,1354,1412,7,2737,NA
OAX,Santa María Apazco,1720,742,978,15,1671,NA
OAX,Santa María la Asunción,3237,1436,1801,10,3174,NA
OAX,Heroica Ciudad de Tlaxiaco,39945,18550,21395,1651,29157,NA
OAX,Ayoquezco de Aldama,4418,2103,2315,405,2686,NA
OAX,Santa María Atzompa,34115,16445,17670,899,14723,Oaxaca
OAX,Santa María Camotlán,1568,742,826,18,603,NA
OAX,Santa María Colotepec,24076,11792,12284,4232,10312,NA
OAX,Santa María Cortijo,1075,521,554,577,303,NA
OAX,Santa María Coyotepec,2971,1422,1549,261,1974,Oaxaca
OAX,Santa María Chachoápam,733,347,386,0,537,NA
OAX,Villa de Chilapa de Díaz,2110,947,1163,12,1697,NA
OAX,Santa María Chilchotla,20328,9854,10474,126,19878,NA
OAX,Santa María Chimalapa,9078,4569,4509,0,0,NA
OAX,Santa María del Rosario,482,246,236,0,403,NA
OAX,Santa María del Tule,8918,4139,4779,136,3834,Oaxaca
OAX,Santa María Ecatepec,3353,1654,1699,39,3171,NA
OAX,Santa María Guelacé,813,369,444,0,647,NA
OAX,Santa María Guienagati,3168,1551,1617,30,3009,NA
OAX,Santa María Huatulco,45680,22295,23385,1769,16357,NA
OAX,Santa María Huazolotitlán,11400,5599,5801,5634,5161,NA
OAX,Santa María Ipalapa,4990,2392,2598,1140,2703,NA
OAX,Santa María Ixcatlán,488,231,257,0,388,NA
OAX,Santa María Jacatepec,9474,4444,5030,1071,7173,NA
OAX,Santa María Jalapa del Marqués,13148,6442,6706,248,8870,NA
OAX,Santa María Jaltianguis,499,226,273,164,465,NA
OAX,Santa María Lachixío,1844,860,984,17,1351,NA
OAX,Santa María Mixtequilla,4555,2189,2366,118,2811,NA
OAX,Santa María Nativitas,585,269,316,0,519,NA
OAX,Santa María Nduayaco,466,233,233,0,359,NA
OAX,Santa María Ozolotepec,3894,1883,2011,54,3572,NA
OAX,Santa María Pápalo,2086,1027,1059,2,2072,NA
OAX,Santa María Peñoles,8593,4165,4428,1734,8317,NA
OAX,Santa María Petapa,16518,7864,8654,0,0,NA
OAX,Santa María Quiegolani,1924,964,960,6,1888,NA
OAX,Santa María Sola,1471,717,754,72,1067,NA
OAX,Santa María Tataltepec,360,173,187,0,351,NA
OAX,Santa María Tecomavaca,1692,818,874,195,1416,NA
OAX,Santa María Temaxcalapa,901,450,451,1,883,NA
OAX,Santa María Temaxcaltepec,2571,1206,1365,27,2419,NA
OAX,Santa María Teopoxco,4214,1943,2271,26,4088,NA
OAX,Santa María Tepantlali,3465,1693,1772,24,3428,NA
OAX,Santa María Texcatitlán,981,467,514,3,975,NA
OAX,Santa María Tlahuitoltepec,8922,4248,4674,31,8777,NA
OAX,Santa María Tlalixtac,1635,806,829,7,1579,NA
OAX,Santa María Tonameca,25130,12378,12752,706,16722,NA
OAX,Santa María Totolapilla,839,403,436,19,717,NA
OAX,Santa María Xadani,8795,4340,4455,22,8339,NA
OAX,Santa María Yalina,267,125,142,0,266,NA
OAX,Santa María Yavesía,472,212,260,0,464,NA
OAX,Santa María Yolotepec,411,190,221,0,410,NA
OAX,Santa María Yosoyúa,1514,748,766,268,1494,NA
OAX,Santa María Yucuhiti,6048,2870,3178,73,6021,NA
OAX,Santa María Zacatepec,16340,7756,8584,1745,7609,NA
OAX,Santa María Zaniza,2234,1063,1171,1,2192,NA
OAX,Santa María Zoquitlán,2939,1441,1498,1,68,NA
OAX,Santiago Amoltepec,12683,6100,6583,366,12210,NA
OAX,Santiago Apoala,875,406,469,6,847,NA
OAX,Santiago Apóstol,3995,1799,2196,164,3555,NA
OAX,Santiago Astata,3708,1848,1860,8,3312,NA
OAX,Santiago Atitlán,2920,1453,1467,13,2888,NA
OAX,Santiago Ayuquililla,2583,1217,1366,413,1731,NA
OAX,Santiago Cacaloxtepec,1441,691,750,168,1256,NA
OAX,Santiago Camotlán,3082,1488,1594,2,3031,NA
OAX,Santiago Comaltepec,967,456,511,15,950,NA
OAX,Santiago Chazumba,4371,1937,2434,70,2679,NA
OAX,Santiago Choápam,4983,2384,2599,7,4916,NA
OAX,Santiago del Río,518,242,276,2,279,NA
OAX,Santiago Huajolotitlán,4083,1888,2195,115,1179,NA
OAX,Santiago Huauclilla,529,248,281,28,424,NA
OAX,Santiago Ihuitlán Plumas,351,153,198,4,172,NA
OAX,Santiago Ixcuintepec,1598,774,824,161,1578,NA
OAX,Santiago Ixtayutla,13041,6278,6763,20,11885,NA
OAX,Santiago Jamiltepec,19201,9134,10067,4147,11177,NA
OAX,Santiago Jocotepec,14135,6910,7225,44,13383,NA
OAX,Santiago Juxtlahuaca,36275,17285,18990,1159,32495,NA
OAX,Santiago Lachiguiri,4886,2445,2441,87,4576,NA
OAX,Santiago Lalopa,498,250,248,2,491,NA
OAX,Santiago Laollaga,3326,1642,1684,192,2534,NA
OAX,Santiago Laxopa,1292,608,684,0,1286,NA
OAX,Santiago Llano Grande,3284,1633,1651,1616,605,NA
OAX,Santiago Matatlán,9681,4498,5183,36,9133,NA
OAX,Santiago Miltepec,393,189,204,3,238,NA
OAX,Santiago Minas,1445,705,740,242,540,NA
OAX,Santiago Nacaltepec,1785,842,943,9,880,NA
OAX,Santiago Nejapilla,202,104,98,1,147,NA
OAX,Santiago Nundiche,877,412,465,1,856,NA
OAX,Santiago Nuyoó,1820,868,952,0,1797,NA
OAX,Santiago Pinotepa Nacional,53148,25833,27315,18002,27597,NA
OAX,Santiago Suchilquitongo,10397,4985,5412,233,6159,NA
OAX,Santiago Tamazola,4250,2015,2235,33,3590,NA
OAX,Santiago Tapextla,3208,1623,1585,2686,1090,NA
OAX,Villa Tejúpam de la Unión,2403,1149,1254,12,1946,NA
OAX,Santiago Tenango,1995,995,1000,42,1135,NA
OAX,Santiago Tepetlapa,114,50,64,0,57,NA
OAX,Santiago Tetepec,4994,2495,2499,1276,3432,NA
OAX,Santiago Texcalcingo,3098,1479,1619,6,3048,NA
OAX,Santiago Textitlán,4404,2198,2206,160,3782,NA
OAX,Santiago Tilantongo,2956,1349,1607,17,2798,NA
OAX,Santiago Tillo,523,242,281,13,362,NA
OAX,Santiago Tlazoyaltepec,4662,2108,2554,246,4632,NA
OAX,Santiago Xanica,3101,1552,1549,290,2873,NA
OAX,Santiago Xiacuí,1736,828,908,0,1656,NA
OAX,Santiago Yaitepec,4352,1980,2372,49,4204,NA
OAX,Santiago Yaveo,6885,3430,3455,20,5382,NA
OAX,Santiago Yolomécatl,2090,955,1135,35,467,NA
OAX,Santiago Yosondúa,8330,3904,4426,419,7731,NA
OAX,Santiago Yucuyachi,936,456,480,4,735,NA
OAX,Santiago Zacatepec,5187,2537,2650,16,5105,NA
OAX,Santiago Zoochila,402,196,206,1,401,NA
OAX,Nuevo Zoquiápam,1654,797,857,1,1453,NA
OAX,Santo Domingo Ingenio,7965,3949,4016,69,3786,NA
OAX,Santo Domingo Albarradas,755,355,400,5,745,NA
OAX,Santo Domingo Armenta,3469,1722,1747,2640,866,NA
OAX,Santo Domingo Chihuitán,1486,722,764,198,1095,NA
OAX,Santo Domingo de Morelos,10738,5112,5626,1070,10143,NA
OAX,Santo Domingo Ixcatlán,652,288,364,2,590,NA
OAX,Santo Domingo Nuxaá,3124,1528,1596,11,3032,NA
OAX,Santo Domingo Ozolotepec,870,421,449,202,684,NA
OAX,Santo Domingo Petapa,9157,4607,4550,3362,8110,NA
OAX,Santo Domingo Roayaga,1020,486,534,2,912,NA
OAX,Santo Domingo Tehuantepec,64639,31016,33623,1018,40341,Tehuantepec
OAX,Santo Domingo Teojomulco,5093,2482,2611,1522,4592,NA
OAX,Santo Domingo Tepuxtepec,4815,2216,2599,123,4645,NA
OAX,Santo Domingo Tlatayápam,132,60,72,0,96,NA
OAX,Santo Domingo Tomaltepec,2988,1477,1511,140,2613,Oaxaca
OAX,Santo Domingo Tonalá,6921,3285,3636,124,4818,NA
OAX,Santo Domingo Tonaltepec,235,113,122,1,197,NA
OAX,Santo Domingo Xagacía,1030,495,535,1,1003,NA
OAX,Santo Domingo Yanhuitlán,1503,703,800,22,1192,NA
OAX,Santo Domingo Yodohino,314,158,156,0,93,NA
OAX,Santo Domingo Zanatepec,12161,6022,6139,151,4341,NA
OAX,Santos Reyes Nopala,17583,8411,9172,170,16440,NA
OAX,Santos Reyes Pápalo,2600,1209,1391,305,2545,NA
OAX,Santos Reyes Tepejillo,980,422,558,57,952,NA
OAX,Santos Reyes Yucuná,1380,679,701,4,1366,NA
OAX,Santo Tomás Jalieza,3617,1703,1914,10,3259,NA
OAX,Santo Tomás Mazaltepec,2632,1261,1371,54,2486,NA
OAX,Santo Tomás Ocotepec,3705,1740,1965,7,3675,NA
OAX,Santo Tomás Tamazulapan,2132,1025,1107,9,1329,NA
OAX,San Vicente Coatlán,3923,1808,2115,7,3632,NA
OAX,San Vicente Lachixío,2961,1377,1584,530,2079,NA
OAX,San Vicente Nuñú,413,193,220,0,90,NA
OAX,Silacayoápam,6495,3032,3463,61,3944,NA
OAX,Sitio de Xitlapehua,669,309,360,2,321,NA
OAX,Soledad Etla,5591,2714,2877,123,2438,Oaxaca
OAX,Villa de Tamazulápam del Progreso,7707,3611,4096,131,4087,NA
OAX,Tanetze de Zaragoza,1622,772,850,1,1579,NA
OAX,Taniche,825,376,449,32,457,NA
OAX,Tataltepec de Valdés,5869,2819,3050,314,5620,NA
OAX,Teococuilco de Marcos Pérez,1016,473,543,3,1004,NA
OAX,Teotitlán de Flores Magón,9876,4593,5283,286,5918,NA
OAX,Teotitlán del Valle,5784,2754,3030,367,5623,NA
OAX,Teotongo,931,426,505,41,824,NA
OAX,Tepelmeme Villa de Morelos,1607,733,874,4,470,NA
OAX,"Heroica Villa Tezoatlán de Segura y Luna, Cuna de la Independencia de Oaxaca",11034,5105,5929,286,8757,NA
OAX,San Jerónimo Tlacochahuaya,5491,2587,2904,104,5009,NA
OAX,Tlacolula de Matamoros,22545,10547,11998,1078,14690,NA
OAX,Tlacotepec Plumas,438,212,226,39,357,NA
OAX,Tlalixtac de Cabrera,10208,4803,5405,1211,7408,Oaxaca
OAX,Totontepec Villa de Morelos,5361,2568,2793,24,5233,NA
OAX,Trinidad Zaachila,3032,1427,1605,36,1972,NA
OAX,La Trinidad Vista Hermosa,260,118,142,2,117,NA
OAX,Unión Hidalgo,15347,7418,7929,190,12521,NA
OAX,Valerio Trujano,1371,627,744,403,1087,NA
OAX,San Juan Bautista Valle Nacional,22699,10883,11816,111,19631,NA
OAX,Villa Díaz Ordaz,6646,3049,3597,694,6323,NA
OAX,Yaxe,2789,1360,1429,4,2344,NA
OAX,Magdalena Yodocono de Porfirio Díaz,1554,758,796,8,1131,NA
OAX,Yogana,1264,580,684,5,896,NA
OAX,Yutanduchi de Guerrero,1129,528,601,25,1034,NA
OAX,Villa de Zaachila,43279,20606,22673,480,20241,Oaxaca
OAX,San Mateo Yucutindoo,3010,1500,1510,38,1669,NA
OAX,Zapotitlán Lagunas,3142,1503,1639,11,2447,NA
OAX,Zapotitlán Palmas,1431,658,773,7,1365,NA
OAX,Santa Inés de Zaragoza,1616,759,857,19,1470,NA
OAX,Zimatlán de Álvarez,19849,9271,10578,845,12068,NA
PUE,Acajete,65048,30952,34096,30,28234,Puebla-Tlaxcala
PUE,Acateno,9095,4492,4603,24,1437,NA
PUE,Acatlán,35764,16588,19176,34,11565,NA
PUE,Acatzingo,59077,28650,30427,6,10951,NA
PUE,Acteopan,2989,1412,1577,0,2387,NA
PUE,Ahuacatlán,15637,7264,8373,7,14724,NA
PUE,Ahuatlán,3186,1498,1688,1,624,NA
PUE,Ahuazotepec,11269,5496,5773,16,3196,NA
PUE,Ahuehuetitla,1803,850,953,16,744,NA
PUE,Ajalpan,65854,31699,34155,14,40721,NA
PUE,Albino Zertuche,1790,822,968,0,1321,NA
PUE,Aljojuca,6521,3135,3386,1,1062,NA
PUE,Altepexi,21100,10258,10842,2,18507,NA
PUE,Amixtlán,4832,2299,2533,0,4187,NA
PUE,Amozoc,117244,56978,60266,129,31481,Puebla-Tlaxcala
PUE,Aquixtla,8768,4329,4439,0,2416,NA
PUE,Atempan,28306,13027,15279,0,23773,NA
PUE,Atexcal,3679,1776,1903,0,1914,NA
PUE,Atlixco,134364,63603,70761,133,43944,NA
PUE,Atoyatempan,7039,3388,3651,0,3332,NA
PUE,Atzala,1326,628,698,3,214,NA
PUE,Atzitzihuacán,12230,5768,6462,6,7497,NA
PUE,Atzitzintla,9344,4601,4743,16,1129,NA
PUE,Axutla,902,419,483,5,301,NA
PUE,Ayotoxco de Guerrero,8558,4167,4391,24,6142,NA
PUE,Calpan,14440,6854,7586,0,6392,NA
PUE,Caltepec,3886,1812,2074,0,3593,NA
PUE,Camocuautla,2624,1283,1341,0,2533,NA
PUE,Caxhuacan,3637,1704,1933,3,3495,NA
PUE,Coatepec,756,362,394,0,672,NA
PUE,Coatzingo,2951,1384,1567,0,259,NA
PUE,Cohetzala,1379,695,684,38,1089,NA
PUE,Cohuecan,4885,2324,2561,0,3456,NA
PUE,Coronango,40949,20055,20894,20,14145,Puebla-Tlaxcala
PUE,Coxcatlán,20459,9587,10872,6,12992,NA
PUE,Coyomeapan,13942,6568,7374,1,13511,NA
PUE,Coyotepec,2221,1017,1204,0,1084,NA
PUE,Cuapiaxtla de Madero,10101,4980,5121,0,2713,NA
PUE,Cuautempan,9337,4499,4838,8,8399,NA
PUE,Cuautinchán,10179,5015,5164,1,5425,NA
PUE,Cuautlancingo,112225,54338,57887,226,23374,Puebla-Tlaxcala
PUE,Cuayuca de Andrade,3163,1545,1618,0,867,NA
PUE,Cuetzalan del Progreso,47983,22916,25067,56,44428,NA
PUE,Cuyoaco,15704,7386,8318,10,4928,NA
PUE,Chalchicomula de Sesma,46778,22124,24654,23,12537,NA
PUE,Chapulco,7752,3718,4034,6,2601,NA
PUE,Chiautla,20155,9686,10469,47,8815,NA
PUE,Chiautzingo,20441,9726,10715,4,6440,Puebla-Tlaxcala
PUE,Chiconcuautla,16569,8030,8539,0,15841,NA
PUE,Chichiquila,25978,12181,13797,91,21607,NA
PUE,Chietla,34415,16563,17852,15,4833,NA
PUE,Chigmecatitlán,1137,499,638,0,907,NA
PUE,Chignahuapan,62028,30268,31760,0,2545,NA
PUE,Chignautla,34196,16279,17917,13,25402,Teziutlán
PUE,Chila,4515,2154,2361,0,166,NA
PUE,Chila de la Sal,1362,645,717,5,567,NA
PUE,Honey,7857,3759,4098,0,1412,NA
PUE,Chilchotla,20010,9800,10210,0,10943,NA
PUE,Chinantla,2221,1044,1177,5,559,NA
PUE,Domingo Arenas,7421,3487,3934,8,1858,Puebla-Tlaxcala
PUE,Eloxochitlán,12520,5903,6617,0,12018,NA
PUE,Epatlán,4879,2382,2497,0,1446,NA
PUE,Esperanza,14974,7214,7760,0,1357,NA
PUE,Francisco Z. Mena,16677,8355,8322,29,8938,NA
PUE,General Felipe Ángeles,20511,9686,10825,0,3801,NA
PUE,Guadalupe,5755,2662,3093,4,1404,NA
PUE,Guadalupe Victoria,16923,8147,8776,2,3357,NA
PUE,Hermenegildo Galeana,7611,3718,3893,0,7314,NA
PUE,Huaquechula,24787,11679,13108,18,11224,NA
PUE,Huatlatlauca,6317,2848,3469,0,5882,NA
PUE,Huauchinango,103509,48672,54837,4,46287,NA
PUE,Huehuetla,18803,9203,9600,24,18366,NA
PUE,Huehuetlán el Chico,8443,4115,4328,15,1615,NA
PUE,Huejotzingo,73771,35687,38084,63,16367,Puebla-Tlaxcala
PUE,Hueyapan,12897,6089,6808,1,12203,NA
PUE,Hueytamalco,25981,12589,13392,24,7516,NA
PUE,Hueytlalpan,5186,2535,2651,0,5107,NA
PUE,Huitzilan de Serdán,15096,7503,7593,11,14677,NA
PUE,Huitziltepec,5373,2571,2802,0,1722,NA
PUE,Atlequizayan,2562,1208,1354,0,2539,NA
PUE,Ixcamilpa de Guerrero,3635,1723,1912,118,1552,NA
PUE,Ixcaquixtla,8752,4122,4630,3,3930,NA
PUE,Ixtacamaxtitlán,24512,11937,12575,3,7608,NA
PUE,Ixtepec,6975,3373,3602,1,6858,NA
PUE,Izúcar de Matamoros,77601,36341,41260,31,16171,NA
PUE,Jalpan,12077,5714,6363,1,5025,NA
PUE,Jolalpan,13120,6346,6774,0,6891,NA
PUE,Jonotla,4504,2201,2303,14,4308,NA
PUE,Jopala,12818,6254,6564,0,8495,NA
PUE,Juan C. Bonilla,21253,10041,11212,6,5355,Puebla-Tlaxcala
PUE,Juan Galindo,10685,4922,5763,7,6009,NA
PUE,Juan N. Méndez,5192,2562,2630,1,2383,NA
PUE,Lafragua,7817,3835,3982,0,699,NA
PUE,Libres,33784,16386,17398,6,7866,NA
PUE,La Magdalena Tlatlauquitepec,469,241,228,0,134,NA
PUE,Mazapiltepec de Juárez,2826,1399,1427,0,77,NA
PUE,Mixtla,2333,1105,1228,1,289,NA
PUE,Molcaxac,6352,2996,3356,0,3248,NA
PUE,Cañada Morelos,19174,9221,9953,5,2284,NA
PUE,Naupan,9974,4747,5227,0,9630,NA
PUE,Nauzontla,3294,1548,1746,3,2553,NA
PUE,Nealtican,12442,5870,6572,2,9137,NA
PUE,Nicolás Bravo,6259,2982,3277,0,2427,NA
PUE,Nopalucan,30848,15138,15710,0,7236,NA
PUE,Ocotepec,4735,2248,2487,0,2075,NA
PUE,Ocoyucan,28220,13425,14795,4,9216,Puebla-Tlaxcala
PUE,Olintla,11517,5565,5952,0,11113,NA
PUE,Oriental,18239,8741,9498,0,4045,NA
PUE,Pahuatlán,22002,10260,11742,0,14354,NA
PUE,Palmar de Bravo,46233,22848,23385,3,3853,NA
PUE,Pantepec,18102,8722,9380,10,15298,NA
PUE,Petlalcingo,9623,4534,5089,11,2266,NA
PUE,Piaxtla,4322,2095,2227,5,720,NA
PUE,Puebla,1576259,746734,829525,3685,383691,Puebla-Tlaxcala
PUE,Quecholac,50962,24784,26178,34,7258,NA
PUE,Quimixtlán,22136,10700,11436,8,10978,NA
PUE,Rafael Lara Grajales,14159,6800,7359,36,4905,NA
PUE,Los Reyes de Juárez,27454,13409,14045,6,3841,NA
PUE,San Andrés Cholula,137290,67537,69753,407,23223,Puebla-Tlaxcala
PUE,San Antonio Cañada,5590,2617,2973,1,3885,NA
PUE,San Diego la Mesa Tochimiltzingo,1198,604,594,0,199,NA
PUE,San Felipe Teotlalcingo,10456,5001,5455,5,1755,Puebla-Tlaxcala
PUE,San Felipe Tepatlán,3838,1859,1979,0,3494,NA
PUE,San Gabriel Chilac,15763,7435,8328,7,12314,NA
PUE,San Gregorio Atzompa,8962,4384,4578,1,2495,Puebla-Tlaxcala
PUE,San Jerónimo Tecuanipan,6265,2969,3296,8,3002,NA
PUE,San Jerónimo Xayacatlán,3441,1610,1831,3,3055,NA
PUE,San José Chiapa,8692,4257,4435,2,325,NA
PUE,San José Miahuatlán,13159,6343,6816,0,12749,NA
PUE,San Juan Atenco,3362,1545,1817,0,738,NA
PUE,San Juan Atzompa,856,445,411,0,459,NA
PUE,San Martín Texmelucan,152051,72952,79099,50,27796,Puebla-Tlaxcala
PUE,San Martín Totoltepec,699,341,358,0,378,NA
PUE,San Matías Tlalancaleca,20175,9861,10314,22,4340,NA
PUE,San Miguel Ixitlán,477,227,250,0,84,NA
PUE,San Miguel Xoxtla,12341,5933,6408,5,3660,Puebla-Tlaxcala
PUE,San Nicolás Buenos Aires,9972,4790,5182,7,1046,NA
PUE,San Nicolás de los Ranchos,11734,5788,5946,0,0,NA
PUE,San Pablo Anicano,3534,1689,1845,1,593,NA
PUE,San Pedro Cholula,129032,61397,67635,163,38180,Puebla-Tlaxcala
PUE,San Pedro Yeloixtlahuaca,3320,1590,1730,1,826,NA
PUE,San Salvador el Seco,30303,14554,15749,3,2883,NA
PUE,San Salvador el Verde,31355,15301,16054,36,6943,Puebla-Tlaxcala
PUE,San Salvador Huixcolotla,14810,7230,7580,5,6188,NA
PUE,San Sebastián Tlacotepec,14092,6944,7148,2,13754,NA
PUE,Santa Catarina Tlaltempan,756,374,382,0,734,NA
PUE,Santa Inés Ahuatempan,6289,2963,3326,0,3778,NA
PUE,Santa Isabel Cholula,9236,4376,4860,0,2347,NA
PUE,Santiago Miahuatlán,25228,12187,13041,110,11738,Tehuacán
PUE,Huehuetlán el Grande,7242,3477,3765,0,3021,NA
PUE,Santo Tomás Hueyotlipan,8511,4088,4423,0,1030,NA
PUE,Soltepec,12226,5911,6315,0,667,NA
PUE,Tecali de Herrera,21992,10647,11345,9,9456,NA
PUE,Tecamachalco,77061,37133,39928,57,9991,NA
PUE,Tecomatlán,5461,2574,2887,50,906,NA
PUE,Tehuacán,319375,150016,169359,549,128319,Tehuacán
PUE,Tehuitzingo,11156,5234,5922,9,1005,NA
PUE,Tenampulco,6975,3400,3575,0,3282,NA
PUE,Teopantlán,3707,1642,2065,0,2887,NA
PUE,Teotlalco,3135,1529,1606,1,433,NA
PUE,Tepanco de López,20580,9758,10822,4,8152,NA
PUE,Tepango de Rodríguez,3947,1845,2102,0,3792,NA
PUE,Tepatlaxco de Hidalgo,17472,8459,9013,2,7296,Puebla-Tlaxcala
PUE,Tepeaca,80507,38159,42348,15,9087,NA
PUE,Tepemaxalco,1124,549,575,0,692,NA
PUE,Tepeojuma,8492,3979,4513,1,2386,NA
PUE,Tepetzintla,11622,5563,6059,0,11406,NA
PUE,Tepexco,6793,3304,3489,3,1267,NA
PUE,Tepexi de Rodríguez,20598,9950,10648,4,9301,NA
PUE,Tepeyahualco,16892,8246,8646,0,1228,NA
PUE,Tepeyahualco de Cuauhtémoc,3534,1681,1853,0,385,NA
PUE,Tetela de Ocampo,28139,13553,14586,2,16165,NA
PUE,Teteles de Avila Castillo,5869,2686,3183,2,3792,NA
PUE,Teziutlán,97590,45918,51672,56,32666,Teziutlán
PUE,Tianguismanalco,12783,6096,6687,6,9033,NA
PUE,Tilapa,8547,4110,4437,12,1438,NA
PUE,Tlacotepec de Benito Juárez,52508,25109,27399,38,30657,NA
PUE,Tlacuilotepec,16496,8021,8475,4,9217,NA
PUE,Tlachichuca,28953,14053,14900,0,1745,NA
PUE,Tlahuapan,40220,19840,20380,21,9085,NA
PUE,Tlaltenango,7125,3480,3645,0,2179,Puebla-Tlaxcala
PUE,Tlanepantla,4957,2344,2613,0,109,NA
PUE,Tlaola,19982,9510,10472,0,16715,NA
PUE,Tlapacoya,6493,3151,3342,0,4806,NA
PUE,Tlapanalá,8444,4054,4390,16,3112,NA
PUE,Tlatlauquitepec,53498,24993,28505,10,27595,NA
PUE,Tlaxco,5345,2646,2699,0,2814,NA
PUE,Tochimilco,17956,8595,9361,0,9411,NA
PUE,Tochtepec,21229,10150,11079,6,5173,NA
PUE,Totoltepec de Guerrero,1180,532,648,0,813,NA
PUE,Tulcingo,9150,4243,4907,38,4201,NA
PUE,Tuzamapan de Galeana,6314,3097,3217,3,5974,NA
PUE,Tzicatlacoyan,7126,3509,3617,0,3253,NA
PUE,Venustiano Carranza,29090,13848,15242,46,4749,NA
PUE,Vicente Guerrero,24660,11760,12900,3,20904,NA
PUE,Xayacatlán de Bravo,1513,699,814,2,1332,NA
PUE,Xicotepec,81455,38757,42698,35,30319,NA
PUE,Xicotlán,1177,559,618,1,634,NA
PUE,Xiutetelco,39959,18806,21153,49,12129,NA
PUE,Xochiapulco,3357,1575,1782,1,2853,NA
PUE,Xochiltepec,3301,1497,1804,0,643,NA
PUE,Xochitlán de Vicente Suárez,12740,6038,6702,0,11788,NA
PUE,Xochitlán Todos Santos,6336,2993,3343,0,797,NA
PUE,Yaonáhuac,7943,3693,4250,2,6929,NA
PUE,Yehualtepec,25057,12107,12950,23,9228,NA
PUE,Zacapala,4396,2080,2316,1,2041,NA
PUE,Zacapoaxtla,55299,25896,29403,18,45047,NA
PUE,Zacatlán,82457,38902,43555,15,27429,NA
PUE,Zapotitlán,8495,3932,4563,3,6326,NA
PUE,Zapotitlán de Méndez,5469,2679,2790,1,5252,NA
PUE,Zaragoza,16173,7358,8815,39,7583,NA
PUE,Zautla,19050,8828,10222,12,16476,NA
PUE,Zihuateutla,13320,6397,6923,8,7565,NA
PUE,Zinacatepec,16817,8014,8803,2,13635,NA
PUE,Zongozotla,4902,2396,2506,10,4792,NA
PUE,Zoquiapan,2442,1125,1317,1,2343,NA
PUE,Zoquitlán,18278,8780,9498,1,17787,NA
QRO,Amealco de Bonfil,61259,29486,31773,5,38968,NA
QRO,Pinal de Amoles,25623,12481,13142,2,3788,NA
QRO,Arroyo Seco,13307,6418,6889,2,2246,NA
QRO,Cadereyta de Montes,69549,32866,36683,41,32026,NA
QRO,Colón,62667,31172,31495,4,15995,NA
QRO,Corregidora,181684,87686,93998,105,16654,Querétaro
QRO,Ezequiel Montes,40572,19391,21181,21,12755,NA
QRO,Huimilpan,38295,17910,20385,5,8064,Querétaro
QRO,Jalpan de Serra,26902,12548,14354,20,5390,NA
QRO,Landa de Matamoros,17947,8499,9448,0,896,NA
QRO,El Marqués,156275,78346,77929,181,25045,Querétaro
QRO,Pedro Escobedo,68313,33287,35026,24,24123,NA
QRO,Peñamiller,20144,9816,10328,2,6794,NA
QRO,Querétaro,878931,431607,447324,1339,126654,Querétaro
QRO,San Joaquín,9480,4414,5066,6,2924,NA
QRO,San Juan del Río,268408,129494,138914,584,33126,NA
QRO,Tequisquiapan,70742,34323,36419,10,11380,NA
QRO,Tolimán,28274,13692,14582,7,24016,NA
QROO,Cozumel,86415,42577,43838,336,32985,NA
QROO,Felipe Carrillo Puerto,81742,40542,41200,36,74906,NA
QROO,Isla Mujeres,19495,10171,9324,125,9137,Cancún
QROO,Othón P. Blanco,224080,108635,115445,1573,87458,NA
QROO,Benito Juárez,743626,370758,372868,4841,287593,Cancún
QROO,José María Morelos,37502,19194,18308,26,33963,NA
QROO,Lázaro Cárdenas,27243,13831,13412,29,22924,NA
QROO,Solidaridad,209634,109224,100410,1287,70447,NA
QROO,Tulum,32714,17125,15589,81,21591,NA
QROO,Bacalar,39111,19481,19630,124,26332,NA
SLP,Ahualulco,18369,8667,9702,0,834,NA
SLP,Alaquines,8296,4048,4248,2,5332,NA
SLP,Aquismón,48772,24417,24355,6,43212,NA
SLP,Armadillo de los Infante,4064,1998,2066,4,153,NA
SLP,Cárdenas,18491,8819,9672,11,2148,NA
SLP,Catorce,9705,4910,4795,1,674,NA
SLP,Cedral,19176,9278,9898,2,1465,NA
SLP,Cerritos,21288,10277,11011,4,1315,NA
SLP,Cerro de San Pedro,4535,2281,2254,7,379,NA
SLP,Ciudad del Maíz,32867,16356,16511,3,2298,NA
SLP,Ciudad Fernández,45385,21929,23456,4,4595,Rioverde
SLP,Tancanhuitz,20550,9987,10563,2,18520,NA
SLP,Ciudad Valles,177022,84834,92188,108,61976,NA
SLP,Coxcatlán,15184,7627,7557,2,14033,NA
SLP,Charcas,20839,10212,10627,4,1786,NA
SLP,Ebano,43569,21307,22262,44,17155,NA
SLP,Guadalcázar,26340,13175,13165,0,2941,NA
SLP,Huehuetlán,15828,7726,8102,0,13086,NA
SLP,Lagunillas,5462,2693,2769,2,786,NA
SLP,Matehuala,99015,47722,51293,62,7164,NA
SLP,Mexquitic de Carmona,57184,27420,29764,5,4107,NA
SLP,Moctezuma,19539,9295,10244,12,323,NA
SLP,Rayón,15279,7351,7928,0,5387,NA
SLP,Rioverde,94191,45495,48696,6,6180,Rioverde
SLP,Salinas,31794,15253,16541,6,3849,NA
SLP,San Antonio,9361,4706,4655,2,9103,NA
SLP,San Ciro de Acosta,10257,4987,5270,0,671,NA
SLP,San Luis Potosí,824229,395823,428406,564,83562,San Luis Potosí
SLP,San Martín Chalchicuautla,21176,10467,10709,0,15806,NA
SLP,San Nicolás Tolentino,5176,2480,2696,6,1713,NA
SLP,Santa Catarina,11791,5652,6139,0,9011,NA
SLP,Santa María del Río,39859,18942,20917,18,4089,NA
SLP,Santo Domingo,12210,6054,6156,0,240,NA
SLP,San Vicente Tancuayalab,14700,7312,7388,2,8452,NA
SLP,Soledad de Graciano Sánchez,309342,149597,159745,89,21725,San Luis Potosí
SLP,Tamasopo,30087,15075,15012,0,9974,NA
SLP,Tamazunchale,92291,45271,47020,24,66714,NA
SLP,Tampacán,15382,7748,7634,0,11484,NA
SLP,Tampamolón Corona,15598,7664,7934,8,13906,NA
SLP,Tamuín,38751,19061,19690,15,19432,NA
SLP,Tanlajás,19750,9915,9835,2,18649,NA
SLP,Tanquián de Escobedo,15120,7338,7782,4,7370,NA
SLP,Tierra Nueva,9383,4371,5012,0,1454,NA
SLP,Vanegas,7629,3809,3820,0,336,NA
SLP,Venado,14486,7108,7378,0,896,NA
SLP,Villa de Arriaga,17888,8732,9156,2,1833,NA
SLP,Villa de Guadalupe,9671,4790,4881,0,275,NA
SLP,Villa de la Paz,5227,2596,2631,3,396,NA
SLP,Villa de Ramos,37184,17893,19291,0,3466,NA
SLP,Villa de Reyes,49385,24403,24982,3,222,NA
SLP,Villa Hidalgo,14830,7328,7502,0,1260,NA
SLP,Villa Juárez,10048,4987,5061,0,269,NA
SLP,Axtla de Terrazas,37645,18437,19208,3,29508,NA
SLP,Xilitla,52062,25277,26785,4,34686,NA
SLP,Zaragoza,26236,12794,13442,2,1507,NA
SLP,Villa de Arista,15258,7532,7726,0,528,NA
SLP,Matlapa,31109,15391,15718,0,28005,NA
SLP,El Naranjo,21955,10908,11047,18,4364,NA
SIN,Ahome,449215,218353,230862,221,127991,NA
SIN,Angostura,47207,23677,23530,16,2806,NA
SIN,Badiraguato,31821,16484,15337,0,282,NA
SIN,Concordia,27157,13599,13558,3,2100,NA
SIN,Cosalá,16292,8286,8006,0,362,NA
SIN,Culiacán,905265,440904,464361,75,49946,NA
SIN,Choix,33027,16720,16307,5,13005,NA
SIN,Elota,53856,27852,26004,184,15502,NA
SIN,Escuinapa,59436,30231,29205,4,4749,NA
SIN,El Fuerte,100459,50177,50282,7,43669,NA
SIN,Guasave,295353,146014,149339,276,50679,NA
SIN,Mazatlán,502547,247428,255119,176,34614,NA
SIN,Mocorito,45351,23248,22103,24,2340,NA
SIN,Rosario,53773,27189,26584,8,2145,NA
SIN,Salvador Alvarado,81109,39247,41862,0,2861,NA
SIN,San Ignacio,21442,11110,10332,10,648,NA
SIN,Sinaloa,88659,44591,44068,0,8303,NA
SIN,Navolato,154352,78975,75377,139,18623,NA
SON,Aconchi,2756,1436,1320,1,219,NA
SON,Agua Prieta,82918,41707,41211,62,8014,NA
SON,Alamos,25694,13207,12487,13,16427,NA
SON,Altar,9578,4706,4872,0,350,NA
SON,Arivechi,1163,590,573,0,96,NA
SON,Arizpe,2677,1366,1311,0,125,NA
SON,Atil,582,293,289,0,1,NA
SON,Bacadéhuachi,1083,571,512,0,3,NA
SON,Bacanora,802,427,375,0,2,NA
SON,Bacerac,1367,701,666,0,46,NA
SON,Bacoachi,1554,771,783,0,79,NA
SON,Bácum,23053,11594,11459,0,8077,NA
SON,Banámichi,1612,807,805,0,16,NA
SON,Baviácora,3312,1716,1596,0,403,NA
SON,Bavispe,1457,771,686,0,0,NA
SON,Benjamín Hill,5233,2539,2694,1,731,NA
SON,Caborca,85631,42964,42667,43,9701,NA
SON,Cajeme,433050,210685,222365,23,59432,NA
SON,Cananea,35892,17759,18133,15,2407,NA
SON,Carbó,4840,2468,2372,9,720,NA
SON,La Colorada,2076,1146,930,0,149,NA
SON,Cucurpe,965,534,431,0,260,NA
SON,Cumpas,6109,3033,3076,0,521,NA
SON,Divisaderos,717,364,353,0,31,NA
SON,Empalme,56177,28183,27994,0,6273,Guaymas
SON,Etchojoa,63216,32102,31114,0,53278,NA
SON,Fronteras,8666,4364,4302,3,702,NA
SON,Granados,1064,534,530,4,92,NA
SON,Guaymas,158046,78434,79612,139,37129,Guaymas
SON,Hermosillo,884273,433646,450627,747,97635,NA
SON,Huachinera,1231,638,593,1,434,NA
SON,Huásabas,890,479,411,0,22,NA
SON,Huatabampo,80524,40185,40339,4,51103,NA
SON,Huépac,927,472,455,0,12,NA
SON,Imuris,12812,6431,6381,24,1683,NA
SON,Magdalena,31180,15538,15642,4,2912,NA
SON,Mazatán,1237,673,564,0,41,NA
SON,Moctezuma,4967,2439,2528,0,261,NA
SON,Naco,6160,3075,3085,14,539,NA
SON,Nácori Chico,2019,1051,968,0,164,NA
SON,Nacozari de García,13843,6876,6967,46,1157,NA
SON,Navojoa,163650,79786,83864,14,64974,NA
SON,Nogales,233952,115994,117958,116,21321,NA
SON,Onavas,468,254,214,0,110,NA
SON,Opodepe,2643,1404,1239,0,672,NA
SON,Oquitoa,372,166,206,0,21,NA
SON,Pitiquito,9514,4859,4655,10,1112,NA
SON,Puerto Peñasco,62177,31519,30658,94,8013,NA
SON,Quiriego,2839,1514,1325,1,2404,NA
SON,Rayón,1444,752,692,0,72,NA
SON,Rosario,5025,2631,2394,0,378,NA
SON,Sahuaripa,5626,2939,2687,0,144,NA
SON,San Felipe de Jesús,407,209,198,0,5,NA
SON,San Javier,557,303,254,0,82,NA
SON,San Luis Río Colorado,192739,96354,96385,140,17412,NA
SON,San Miguel de Horcasitas,9081,4740,4341,28,3717,NA
SON,San Pedro de la Cueva,1481,803,678,0,91,NA
SON,Santa Ana,16248,8016,8232,0,1246,NA
SON,Santa Cruz,1768,860,908,0,173,NA
SON,Sáric,1567,824,743,18,246,NA
SON,Soyopa,1420,764,656,0,42,NA
SON,Suaqui Grande,1142,625,517,0,127,NA
SON,Tepache,1230,635,595,0,193,NA
SON,Trincheras,1577,876,701,1,101,NA
SON,Tubutama,1193,609,584,2,319,NA
SON,Ures,8704,4487,4217,2,870,NA
SON,Villa Hidalgo,1523,801,722,0,82,NA
SON,Villa Pesqueira,1181,642,539,0,67,NA
SON,Yécora,6012,3024,2988,0,1146,NA
SON,General Plutarco Elías Calles,16931,8297,8634,0,0,NA
SON,Benito Juárez,21957,10988,10969,3,13600,NA
SON,San Ignacio Río Muerto,14549,7469,7080,4,8178,NA
TAB,Balancán,60516,30101,30415,4,8681,NA
TAB,Cárdenas,258554,125628,132926,292,28351,NA
TAB,Centla,110130,54577,55553,13,62682,NA
TAB,Centro,684847,333999,350848,1236,148599,Villahermosa
TAB,Comalcalco,201654,98619,103035,251,61447,NA
TAB,Cunduacán,138504,67460,71044,111,44747,NA
TAB,Emiliano Zapata,30637,14562,16075,0,2204,NA
TAB,Huimanguillo,188792,92293,96499,262,25647,NA
TAB,Jalapa,38231,19033,19198,3,4616,NA
TAB,Jalpa de Méndez,87249,43290,43959,40,39637,NA
TAB,Jonuta,30567,15127,15440,15,6885,NA
TAB,Macuspana,165729,80624,85105,78,51299,NA
TAB,Nacajuca,138366,67644,70722,112,58277,Villahermosa
TAB,Paraíso,94375,46870,47505,170,24115,NA
TAB,Tacotalpa,48784,24512,24272,0,28817,NA
TAB,Teapa,58523,28423,30100,24,7326,NA
TAB,Tenosique,59814,28830,30984,41,13873,NA
TAM,Abasolo,12100,6029,6071,4,730,NA
TAM,Aldama,29183,14643,14540,17,1158,NA
TAM,Altamira,235066,116117,118949,410,29131,Tampico
TAM,Antiguo Morelos,9902,4943,4959,6,1204,NA
TAM,Burgos,4428,2277,2151,0,17,NA
TAM,Bustamante,8062,4206,3856,0,22,NA
TAM,Camargo,15762,7886,7876,0,47,NA
TAM,Casas,4179,2189,1990,0,123,NA
TAM,Ciudad Madero,209175,99517,109658,522,29521,Tampico
TAM,Cruillas,1937,981,956,0,5,NA
TAM,Gómez Farías,9186,4687,4499,2,225,NA
TAM,González,43757,21598,22159,8,852,NA
TAM,Güémez,15560,8040,7520,18,876,NA
TAM,Guerrero,4439,2266,2173,1,150,NA
TAM,Gustavo Díaz Ordaz,15398,7774,7624,0,139,NA
TAM,Hidalgo,22799,11642,11157,0,1137,NA
TAM,Jaumave,15296,7808,7488,0,29,NA
TAM,Jiménez,8165,4069,4096,6,175,NA
TAM,Llera,16555,8441,8114,2,157,NA
TAM,Mainero,2493,1261,1232,0,182,NA
TAM,El Mante,117648,56838,60810,0,3251,NA
TAM,Matamoros,520367,253231,267136,196,20184,Matamoros
TAM,Méndez,4122,2144,1978,0,59,NA
TAM,Mier,4326,2133,2193,0,3,NA
TAM,Miguel Alemán,27447,13548,13899,6,506,NA
TAM,Miquihuana,3555,1842,1713,0,4,NA
TAM,Nuevo Laredo,399431,199807,199624,636,25221,Nuevo Laredo
TAM,Nuevo Morelos,3551,1855,1696,0,263,NA
TAM,Ocampo,13828,7062,6766,2,611,NA
TAM,Padilla,13927,6949,6978,0,58,NA
TAM,Palmillas,1705,881,824,0,7,NA
TAM,Reynosa,646202,318952,327250,7135,37681,Reynosa
TAM,Río Bravo,126887,63298,63589,72,7254,Reynosa
TAM,San Carlos,8723,4549,4174,0,13,NA
TAM,San Fernando,55981,27790,28191,19,1549,NA
TAM,San Nicolás,1038,560,478,0,0,NA
TAM,Soto la Marina,25419,12920,12499,6,1023,NA
TAM,Tampico,314418,151295,163123,849,36372,Tampico
TAM,Tula,29560,14738,14822,3,1278,NA
TAM,Valle Hermoso,64188,31473,32715,47,4102,NA
TAM,Victoria,346029,169008,177021,133,9890,NA
TAM,Villagrán,6165,3150,3015,0,207,NA
TAM,Xicoténcatl,23739,11789,11950,3,1269,NA
TLAX,Amaxac de Guerrero,11144,5464,5680,7,4102,Tlaxcala-Apizaco
TLAX,Apetatitlán de Antonio Carvajal,15271,7348,7923,16,3271,Tlaxcala-Apizaco
TLAX,Atlangatepec,6597,3223,3374,3,1094,NA
TLAX,Atltzayanca,17173,8541,8632,2,2810,NA
TLAX,Apizaco,78624,37122,41502,69,11198,Tlaxcala-Apizaco
TLAX,Calpulalpan,48385,23362,25023,0,5147,NA
TLAX,El Carmen Tequexquitla,17259,8402,8857,2,1048,NA
TLAX,Cuapiaxtla,15337,7553,7784,0,2348,NA
TLAX,Cuaxomulco,5272,2592,2680,4,1511,Tlaxcala-Apizaco
TLAX,Chiautempan,70011,33611,36400,35,14959,Tlaxcala-Apizaco
TLAX,Muñoz de Domingo Arenas,4679,2310,2369,3,666,NA
TLAX,Españita,8668,4222,4446,0,2405,NA
TLAX,Huamantla,92887,45122,47765,36,15236,NA
TLAX,Hueyotlipan,14575,7144,7431,3,3076,NA
TLAX,Ixtacuixtla de Mariano Matamoros,38324,18620,19704,16,3878,Puebla-Tlaxcala
TLAX,Ixtenco,7080,3382,3698,10,5470,NA
TLAX,Mazatecochco de José María Morelos,10901,5356,5545,0,3926,Puebla-Tlaxcala
TLAX,Contla de Juan Cuamatzi,38330,18740,19590,0,23016,Tlaxcala-Apizaco
TLAX,Tepetitla de Lardizábal,21060,10011,11049,19,3918,Puebla-Tlaxcala
TLAX,Sanctórum de Lázaro Cárdenas,9490,4636,4854,12,2177,NA
TLAX,Nanacamilpa de Mariano Arista,18115,8775,9340,6,3195,NA
TLAX,Acuamanala de Miguel Hidalgo,5925,2969,2956,0,1552,Puebla-Tlaxcala
TLAX,Natívitas,25053,12039,13014,2,4631,Puebla-Tlaxcala
TLAX,Panotla,27154,13015,14139,8,3533,Tlaxcala-Apizaco
TLAX,San Pablo del Monte,77242,38141,39101,14,42006,Puebla-Tlaxcala
TLAX,Santa Cruz Tlaxcala,20242,9815,10427,2,5429,Tlaxcala-Apizaco
TLAX,Tenancingo,12834,6306,6528,36,7108,Puebla-Tlaxcala
TLAX,Teolocholco,24380,11721,12659,7,11591,Puebla-Tlaxcala
TLAX,Tepeyanco,12047,5747,6300,7,946,Puebla-Tlaxcala
TLAX,Terrenate,14746,7356,7390,15,7942,NA
TLAX,Tetla de la Solidaridad,32613,15974,16639,41,8973,Tlaxcala-Apizaco
TLAX,Tetlatlahuca,13414,6475,6939,6,2461,Puebla-Tlaxcala
TLAX,Tlaxcala,95051,44855,50196,63,14153,Tlaxcala-Apizaco
TLAX,Tlaxco,42536,20670,21866,11,6070,NA
TLAX,Tocatlán,5843,2856,2987,0,804,Tlaxcala-Apizaco
TLAX,Totolac,21814,10338,11476,33,2415,Tlaxcala-Apizaco
TLAX,Ziltlaltépec de Trinidad Sánchez Santos,8955,4266,4689,0,6039,NA
TLAX,Tzompantepec,16359,7768,8591,63,7901,Tlaxcala-Apizaco
TLAX,Xaloztoc,23905,11855,12050,26,8507,Tlaxcala-Apizaco
TLAX,Xaltocan,10263,4938,5325,3,2257,NA
TLAX,Papalotla de Xicohténcatl,30364,14564,15800,71,7343,Puebla-Tlaxcala
TLAX,Xicohtzinco,13629,6413,7216,13,4059,Puebla-Tlaxcala
TLAX,Yauhquemehcan,38296,18389,19907,24,8561,Tlaxcala-Apizaco
TLAX,Zacatelco,42686,20186,22500,34,10597,Puebla-Tlaxcala
TLAX,Benito Juárez,6038,2960,3078,4,1813,NA
TLAX,Emiliano Zapata,4561,2210,2351,1,1193,NA
TLAX,Lázaro Cárdenas,3103,1533,1570,4,272,NA
TLAX,La Magdalena Tlaltelulco,18873,8956,9917,11,8157,Tlaxcala-Apizaco
TLAX,San Damián Texóloc,5569,2759,2810,8,1477,Tlaxcala-Apizaco
TLAX,San Francisco Tetlanohcan,10910,5333,5577,4,7374,Tlaxcala-Apizaco
TLAX,San Jerónimo Zacualpan,3767,1790,1977,0,572,Puebla-Tlaxcala
TLAX,San José Teacalco,5923,2857,3066,1,965,NA
TLAX,San Juan Huactzinco,7511,3580,3931,0,858,Puebla-Tlaxcala
TLAX,San Lorenzo Axocomanitla,5618,2701,2917,7,1229,Puebla-Tlaxcala
TLAX,San Lucas Tecopilco,3131,1549,1582,0,757,NA
TLAX,Santa Ana Nopalucan,7773,3793,3980,0,1659,Puebla-Tlaxcala
TLAX,Santa Apolonia Teacalco,4559,2145,2414,3,933,Puebla-Tlaxcala
TLAX,Santa Catarina Ayometla,8817,4200,4617,22,2497,Puebla-Tlaxcala
TLAX,Santa Cruz Quilehtla,7169,3579,3590,0,790,Puebla-Tlaxcala
TLAX,Santa Isabel Xiloxoxtla,4992,2428,2564,1,1435,Tlaxcala-Apizaco
VER,Acajete,8819,4422,4397,174,2063,NA
VER,Acatlán,3147,1544,1603,144,449,NA
VER,Acayucan,87267,41772,45495,2425,24840,Acayucan
VER,Actopan,43388,21287,22101,1985,2646,NA
VER,Acula,5350,2674,2676,306,1139,NA
VER,Acultzingo,22969,11169,11800,449,10058,NA
VER,Camarón de Tejeda,6426,3202,3224,10,412,NA
VER,Alpatláhuac,10189,5037,5152,50,1434,NA
VER,Alto Lucero de Gutiérrez Barrios,28922,14395,14527,2227,3449,NA
VER,Altotonga,65548,31417,34131,177,9327,NA
VER,Alvarado,52927,25983,26944,273,1342,Veracruz
VER,Amatitlán,7987,3896,4091,153,190,NA
VER,Naranjos Amatlán,28295,13338,14957,2550,13500,NA
VER,Amatlán de los Reyes,45430,21486,23944,2198,13378,Córdoba
VER,Angel R. Cabada,33730,16309,17421,797,2237,NA
VER,La Antigua,26920,12875,14045,517,3120,NA
VER,Apazapan,4009,1992,2017,51,881,NA
VER,Aquila,1924,925,999,9,648,NA
VER,Astacinga,6534,3095,3439,342,6465,NA
VER,Atlahuilco,10933,5328,5605,14,10413,NA
VER,Atoyac,23896,11665,12231,699,4842,NA
VER,Atzacan,21360,10378,10982,124,3516,Orizaba
VER,Atzalan,50873,25019,25854,544,4206,NA
VER,Tlaltetela,15818,7977,7841,134,3474,NA
VER,Ayahualulco,26694,13046,13648,95,1557,NA
VER,Banderilla,24822,11786,13036,285,4147,Xalapa
VER,Benito Juárez,17618,8544,9074,776,16376,NA
VER,Boca del Río,142207,66717,75490,3607,14330,Veracruz
VER,Calcahualco,12929,6367,6562,59,5433,NA
VER,Camerino Z. Mendoza,42347,19675,22672,296,12139,Orizaba
VER,Carrillo Puerto,16996,8357,8639,3147,4866,NA
VER,Catemaco,49651,23782,25869,490,6656,NA
VER,Cazones de Herrera,23675,11340,12335,1898,13432,Poza Rica
VER,Cerro Azul,26807,12578,14229,381,5624,NA
VER,Citlaltépetl,12109,5843,6266,519,9911,NA
VER,Coacoatzintla,10482,5066,5416,90,1348,NA
VER,Coahuitlán,8566,4123,4443,37,8250,NA
VER,Coatepec,92127,43901,48226,2461,16786,Xalapa
VER,Coatzacoalcos,319187,152418,166769,11972,79770,Coatzacoalcos
VER,Coatzintla,56897,27624,29273,520,26411,Poza Rica
VER,Coetzala,2236,1090,1146,11,1287,NA
VER,Colipa,5718,2791,2927,28,161,NA
VER,Comapa,19859,10095,9764,223,3507,NA
VER,Córdoba,218153,102479,115674,3913,25610,Córdoba
VER,Cosamaloapan de Carpio,57147,27069,30078,7116,9613,NA
VER,Cosautlán de Carvajal,16353,8063,8290,51,539,NA
VER,Coscomatepec,58479,28714,29765,412,9032,NA
VER,Cosoleacaque,129527,62700,66827,3596,50587,Minatitlán
VER,Cotaxtla,21013,10486,10527,1044,1578,NA
VER,Coxquihui,16754,8118,8636,65,16151,NA
VER,Coyutla,22570,10758,11812,566,20566,NA
VER,Cuichapa,12238,5838,6400,122,2060,NA
VER,Cuitláhuac,27940,13415,14525,1570,4901,NA
VER,Chacaltianguis,12494,6034,6460,70,337,NA
VER,Chalma,13479,6588,6891,200,9612,NA
VER,Chiconamel,6684,3181,3503,42,6178,NA
VER,Chiconquiaco,14394,7093,7301,38,3294,NA
VER,Chicontepec,55844,27299,28545,99,50552,NA
VER,Chinameca,16241,7834,8407,794,6275,Minatitlán
VER,Chinampa de Gorostiza,16741,8207,8534,860,7808,NA
VER,Las Choapas,81827,39677,42150,1020,11204,NA
VER,Chocamán,21102,10476,10626,725,4012,NA
VER,Chontla,14565,7145,7420,610,9376,NA
VER,Chumatlán,3880,1852,2028,53,3839,NA
VER,Emiliano Zapata,78336,37896,40440,4032,11559,Xalapa
VER,Espinal,27297,13235,14062,839,24209,NA
VER,Filomeno Mata,18367,9128,9239,113,18145,NA
VER,Fortín,66168,31198,34970,1989,9390,Córdoba
VER,Gutiérrez Zamora,24791,11665,13126,184,9453,NA
VER,Hidalgotitlán,19587,9905,9682,1406,6958,NA
VER,Huatusco,60674,29144,31530,2055,14065,NA
VER,Huayacocotla,21391,10297,11094,492,5514,NA
VER,Hueyapan de Ocampo,43309,20960,22349,493,20126,NA
VER,Huiloapan de Cuauhtémoc,7221,3463,3758,33,987,Orizaba
VER,Ignacio de la Llave,17105,8052,9053,452,3060,NA
VER,Ilamatlán,13474,6424,7050,16,12768,NA
VER,Isla,43349,21018,22331,611,4956,NA
VER,Ixcatepec,13591,6772,6819,18,12654,NA
VER,Ixhuacán de los Reyes,11442,5663,5779,48,2186,NA
VER,Ixhuatlán del Café,23005,11448,11557,347,3774,NA
VER,Ixhuatlancillo,24896,11778,13118,502,11389,Orizaba
VER,Ixhuatlán del Sureste,15800,7913,7887,468,4597,Coatzacoalcos
VER,Ixhuatlán de Madero,54132,26299,27833,1058,46425,NA
VER,Ixmatlahuacan,5790,2833,2957,270,1065,NA
VER,Ixtaczoquitlán,68823,33177,35646,4029,21018,Orizaba
VER,Jalacingo,44488,21365,23123,337,7644,NA
VER,Xalapa,480841,226546,254295,16111,88808,Xalapa
VER,Jalcomulco,5006,2492,2514,45,933,NA
VER,Jáltipan,41644,19761,21883,5823,23074,Minatitlán
VER,Jamapa,11361,5495,5866,273,1836,Veracruz
VER,Jesús Carranza,29413,14617,14796,649,8035,NA
VER,Xico,38198,18653,19545,953,7051,NA
VER,Jilotepec,16682,8133,8549,662,3874,Xalapa
VER,Juan Rodríguez Clara,38895,19082,19813,1505,7906,NA
VER,Juchique de Ferrer,15916,7917,7999,211,545,NA
VER,Landero y Coss,1534,753,781,58,610,NA
VER,Lerdo de Tejada,19606,9072,10534,1403,3103,NA
VER,Magdalena,3043,1479,1564,169,2973,NA
VER,Maltrata,18096,8759,9337,31,766,Orizaba
VER,Manlio Fabio Altamirano,23408,11366,12042,106,3027,NA
VER,Mariano Escobedo,37285,17831,19454,1154,10247,Orizaba
VER,Martínez de la Torre,110415,52496,57919,1060,19452,NA
VER,Mecatlán,12332,6008,6324,350,12166,NA
VER,Mecayapan,17312,8319,8993,978,15691,NA
VER,Medellín de Bravo,75346,36209,39137,5552,14647,Veracruz
VER,Miahuatlán,4685,2312,2373,43,116,NA
VER,Las Minas,2920,1468,1452,39,130,NA
VER,Minatitlán,157393,75724,81669,2875,23181,Minatitlán
VER,Misantla,64249,31071,33178,160,16740,NA
VER,Mixtla de Altamirano,11646,5801,5845,157,11465,NA
VER,Moloacán,17504,8407,9097,558,2911,NA
VER,Naolinco,21816,10592,11224,1090,4523,NA
VER,Naranjal,4559,2203,2356,894,3242,NA
VER,Nautla,10866,5340,5526,82,1036,NA
VER,Nogales,37908,17888,20020,925,9024,Orizaba
VER,Oluta,16710,7973,8737,855,6458,Acayucan
VER,Omealca,24020,11609,12411,89,4698,NA
VER,Orizaba,126005,57660,68345,1261,15909,Orizaba
VER,Otatitlán,5703,2719,2984,503,1957,NA
VER,Oteapan,16222,7904,8318,416,9619,Minatitlán
VER,Ozuluama de Mascareñas,23244,11703,11541,987,3738,NA
VER,Pajapan,17480,8672,8808,421,16263,NA
VER,Pánuco,100549,49550,50999,1055,15474,Tampico
VER,Papantla,161097,80303,80794,14003,123029,Poza Rica
VER,Paso del Macho,31890,15607,16283,191,4161,NA
VER,Paso de Ovejas,33392,16457,16935,991,4505,NA
VER,La Perla,26880,13064,13816,95,22773,NA
VER,Perote,72795,35345,37450,1710,9597,NA
VER,Platón Sánchez,18145,8860,9285,20,8894,NA
VER,Playa Vicente,39205,18722,20483,1041,17047,NA
VER,Poza Rica de Hidalgo,200119,94411,105708,8394,65631,Poza Rica
VER,Las Vigas de Ramírez,19725,9721,10004,815,3842,NA
VER,Pueblo Viejo,57646,28418,29228,3360,17107,Tampico
VER,Puente Nacional,22454,10978,11476,694,1053,NA
VER,Rafael Delgado,23112,11165,11947,370,17346,Orizaba
VER,Rafael Lucio,8068,3870,4198,178,747,Xalapa
VER,Los Reyes,5830,2885,2945,3,5737,NA
VER,Río Blanco,41927,19692,22235,463,5806,Orizaba
VER,Saltabarranca,6147,2964,3183,3,18,NA
VER,San Andrés Tenejapan,2921,1420,1501,17,2488,NA
VER,San Andrés Tuxtla,164834,78655,86179,8304,27408,NA
VER,San Juan Evangelista,33929,16496,17433,1736,5059,NA
VER,Santiago Tuxtla,57466,27522,29944,335,7217,NA
VER,Sayula de Alemán,32721,16084,16637,253,14938,NA
VER,Soconusco,16363,7880,8483,436,4544,Acayucan
VER,Sochiapa,3656,1804,1852,10,576,NA
VER,Soledad Atzompa,23130,11425,11705,629,22804,NA
VER,Soledad de Doblado,27770,13690,14080,1186,4178,NA
VER,Soteapan,35155,17035,18120,518,33232,NA
VER,Tamalín,11750,5831,5919,48,6432,NA
VER,Tamiahua,23120,11546,11574,1969,8156,NA
VER,Tampico Alto,12320,6304,6016,46,1758,NA
VER,Tancoco,5792,2779,3013,840,3267,NA
VER,Tantima,12983,6574,6409,417,5687,NA
VER,Tantoyuca,103616,50578,53038,1755,78991,NA
VER,Tatatila,5767,2960,2807,11,213,NA
VER,Castillo de Teayo,20037,10117,9920,358,9300,NA
VER,Tecolutla,23865,11698,12167,2519,14739,NA
VER,Tehuipango,26322,12677,13645,1157,25884,NA
VER,Álamo Temapache,104694,51809,52885,1660,49312,NA
VER,Tempoal,35823,17423,18400,2072,15183,NA
VER,Tenampa,6677,3309,3368,130,1760,NA
VER,Tenochtitlán,5189,2558,2631,15,642,NA
VER,Teocelo,16480,7868,8612,54,1299,NA
VER,Tepatlaxco,8417,4285,4132,16,1127,NA
VER,Tepetlán,9668,4884,4784,3,359,NA
VER,Tepetzintla,14736,7183,7553,2003,10951,NA
VER,Tequila,15018,7383,7635,44,14767,NA
VER,José Azueta,22923,11219,11704,173,3677,NA
VER,Texcatepec,10934,5328,5606,159,10058,NA
VER,Texhuacán,5284,2495,2789,13,5190,NA
VER,Texistepec,20887,10389,10498,104,9343,NA
VER,Tezonapa,56956,27934,29022,3188,29717,NA
VER,Tierra Blanca,106277,50858,55419,3238,7166,NA
VER,Tihuatlán,96418,46745,49673,5968,39721,Poza Rica
VER,Tlacojalpan,4953,2413,2540,1058,522,NA
VER,Tlacolulan,11431,5755,5676,110,2893,NA
VER,Tlacotalpan,13421,6372,7049,252,414,NA
VER,Tlacotepec de Mejía,3833,1884,1949,163,630,NA
VER,Tlachichilco,11630,5687,5943,62,8351,NA
VER,Tlalixcoyan,37857,18621,19236,265,3360,NA
VER,Tlalnelhuayocan,18715,9205,9510,1460,3664,Xalapa
VER,Tlapacoyan,61982,29969,32013,1160,24847,NA
VER,Tlaquilpa,7709,3600,4109,711,7468,NA
VER,Tlilapan,5258,2534,2724,161,3480,Orizaba
VER,Tomatlán,6869,3363,3506,61,1368,NA
VER,Tonayán,5670,2730,2940,109,997,NA
VER,Totutla,17428,8562,8866,221,1290,NA
VER,Tuxpan,161829,77949,83880,5950,38094,NA
VER,Tuxtilla,2185,1073,1112,7,17,NA
VER,Ursulo Galván,30580,14868,15712,595,3345,NA
VER,Vega de Alatorre,20275,9760,10515,518,2994,NA
VER,Veracruz,609964,290148,319816,25428,83336,Veracruz
VER,Villa Aldama,11760,5747,6013,1157,1390,NA
VER,Xoxocotla,5446,2761,2685,2033,5026,NA
VER,Yanga,17896,8350,9546,1064,2012,Córdoba
VER,Yecuatla,12108,5950,6158,30,828,NA
VER,Zacualpan,7194,3466,3728,32,1472,NA
VER,Zaragoza,11354,5505,5849,1300,10625,Minatitlán
VER,Zentla,13409,6761,6648,20,757,NA
VER,Zongolica,43871,21465,22406,118,41542,NA
VER,Zontecomatlán de López y Fuentes,14620,7125,7495,31,13755,NA
VER,Zozocolco de Hidalgo,15031,7240,7791,1405,14419,NA
VER,Agua Dulce,48091,23118,24973,932,2946,NA
VER,El Higo,19478,9626,9852,92,5991,NA
VER,Nanchital de Lázaro Cárdenas del Río,30039,14589,15450,3612,9197,Coatzacoalcos
VER,Tres Valles,46672,22603,24069,1551,7188,NA
VER,Carlos A. Carrillo,24565,11735,12830,726,2215,NA
VER,Tatahuicapan de Juárez,15614,7501,8113,1635,14568,NA
VER,Uxpanapa,29434,14795,14639,1350,18208,NA
VER,San Rafael,29631,14536,15095,1497,5951,NA
VER,Santiago Sochiapan,12512,5996,6516,64,11183,NA
YUC,Abalá,6502,3280,3222,1,6050,NA
YUC,Acanceh,16127,8067,8060,0,13416,NA
YUC,Akil,11312,5519,5793,0,10224,NA
YUC,Baca,5811,2860,2951,0,4339,NA
YUC,Bokobá,2191,1103,1088,0,2135,NA
YUC,Buctzotz,8887,4440,4447,1,6757,NA
YUC,Cacalchén,7224,3707,3517,3,6247,NA
YUC,Calotmul,3992,1968,2024,1,3679,NA
YUC,Cansahcab,4580,2266,2314,3,3804,NA
YUC,Cantamayec,2519,1300,1219,0,2410,NA
YUC,Celestún,7836,3991,3845,1,5919,NA
YUC,Cenotillo,3886,1909,1977,6,2878,NA
YUC,Conkal,11141,5548,5593,9,7075,Mérida
YUC,Cuncunul,1572,791,781,0,1487,NA
YUC,Cuzamá,5181,2622,2559,0,4348,NA
YUC,Chacsinkín,3015,1526,1489,1,2865,NA
YUC,Chankom,4583,2309,2274,1,4446,NA
YUC,Chapab,3153,1587,1566,0,2984,NA
YUC,Chemax,36881,18521,18360,6,35663,NA
YUC,Chicxulub Pueblo,4468,2253,2215,2,2287,NA
YUC,Chichimilá,8371,4223,4148,0,7899,NA
YUC,Chikindzonot,4166,2097,2069,1,3839,NA
YUC,Chocholá,4691,2358,2333,1,3601,NA
YUC,Chumayel,3308,1622,1686,1,3160,NA
YUC,Dzán,5357,2638,2719,0,5150,NA
YUC,Dzemul,3662,1804,1858,2,3390,NA
YUC,Dzidzantún,8176,4123,4053,8,5245,NA
YUC,Dzilam de Bravo,2744,1402,1342,1,1503,NA
YUC,Dzilam González,6120,3128,2992,0,3242,NA
YUC,Dzitás,3783,1928,1855,0,3595,NA
YUC,Dzoncauich,2609,1272,1337,1,2342,NA
YUC,Espita,16071,8091,7980,0,15109,NA
YUC,Halachó,20152,10155,9997,0,18674,NA
YUC,Hocabá,6089,3029,3060,0,5681,NA
YUC,Hoctún,5976,2956,3020,1,5216,NA
YUC,Homún,7670,3869,3801,0,6976,NA
YUC,Huhí,5218,2638,2580,2,4774,NA
YUC,Hunucmá,32475,16046,16429,15,25373,NA
YUC,Ixil,4073,2052,2021,3,2670,NA
YUC,Izamal,26801,13232,13569,9,22743,NA
YUC,Kanasín,96317,47434,48883,25,42797,Mérida
YUC,Kantunil,5455,2585,2870,0,4648,NA
YUC,Kaua,3119,1562,1557,1,3059,NA
YUC,Kinchil,7187,3639,3548,0,6498,NA
YUC,Kopomá,2515,1295,1220,0,2405,NA
YUC,Mama,3210,1534,1676,1,3047,NA
YUC,Maní,5637,2756,2881,3,5415,NA
YUC,Maxcanú,22619,11366,11253,16,20757,NA
YUC,Mayapán,3700,1921,1779,0,3016,NA
YUC,Mérida,892363,428715,463648,1886,430620,Mérida
YUC,Mocochá,3218,1624,1594,0,2210,NA
YUC,Motul,36097,17901,18196,28,26485,NA
YUC,Muna,12722,6251,6471,11,10251,NA
YUC,Muxupip,2837,1387,1450,0,1667,NA
YUC,Opichén,6789,3405,3384,0,6322,NA
YUC,Oxkutzcab,31202,15032,16170,21,23144,NA
YUC,Panabá,7792,3863,3929,1,6789,NA
YUC,Peto,25264,12487,12777,5,24009,NA
YUC,Progreso,59122,29264,29858,238,30799,NA
YUC,Quintana Roo,963,482,481,0,881,NA
YUC,Río Lagartos,3502,1785,1717,1,2534,NA
YUC,Sacalum,4819,2441,2378,1,4285,NA
YUC,Samahil,5119,2520,2599,0,4475,NA
YUC,Sanahcat,1678,837,841,0,1426,NA
YUC,San Felipe,1945,987,958,1,1587,NA
YUC,Santa Elena,4047,1999,2048,0,3879,NA
YUC,Seyé,9724,4944,4780,0,7135,NA
YUC,Sinanché,3088,1602,1486,0,2515,NA
YUC,Sotuta,8902,4499,4403,2,8332,NA
YUC,Sucilá,3918,2013,1905,2,3077,NA
YUC,Sudzal,1710,896,814,0,918,NA
YUC,Suma,1762,904,858,0,1199,NA
YUC,Tahdziú,5111,2623,2488,0,4943,NA
YUC,Tahmek,3641,1851,1790,5,3203,NA
YUC,Teabo,6551,3267,3284,0,6366,NA
YUC,Tecoh,17609,8746,8863,6,14849,NA
YUC,Tekal de Venegas,2616,1327,1289,0,2101,NA
YUC,Tekantó,3786,1883,1903,0,3618,NA
YUC,Tekax,42440,20808,21632,2,36689,NA
YUC,Tekit,10232,5197,5035,11,9251,NA
YUC,Tekom,3216,1585,1631,0,3119,NA
YUC,Telchac Pueblo,3704,1839,1865,2,2297,NA
YUC,Telchac Puerto,1778,916,862,0,1605,NA
YUC,Temax,7210,3590,3620,2,5984,NA
YUC,Temozón,15503,7849,7654,0,15081,NA
YUC,Tepakán,2134,1086,1048,0,2023,NA
YUC,Tetiz,5124,2588,2536,0,4868,NA
YUC,Teya,1916,956,960,0,1758,NA
YUC,Ticul,40161,19726,20435,16,32745,NA
YUC,Timucuy,7362,3729,3633,2,6808,NA
YUC,Tinum,11942,6044,5898,0,11551,NA
YUC,Tixcacalcupul,7157,3567,3590,0,7020,NA
YUC,Tixkokob,17787,8791,8996,17,15070,NA
YUC,Tixmehuac,4813,2372,2441,2,4732,NA
YUC,Tixpéhual,5407,2640,2767,0,3418,NA
YUC,Tizimín,77621,37859,39762,17,57471,NA
YUC,Tunkás,3522,1795,1727,1,3059,NA
YUC,Tzucacab,14784,7402,7382,4,12712,NA
YUC,Uayma,4056,2068,1988,0,3936,NA
YUC,Ucú,3682,1838,1844,0,3104,Mérida
YUC,Umán,55261,27486,27775,37,32996,Mérida
YUC,Valladolid,80313,39793,40520,97,62547,NA
YUC,Xocchel,3482,1764,1718,0,2615,NA
YUC,Yaxcabá,15203,7761,7442,0,14817,NA
YUC,Yaxkukul,3109,1528,1581,10,1971,NA
YUC,Yobaín,2227,1114,1113,1,1922,NA
ZAC,Apozol,6086,2930,3156,0,432,NA
ZAC,Apulco,4738,2267,2471,4,638,NA
ZAC,Atolinga,2427,1181,1246,0,231,NA
ZAC,Benito Juárez,3990,2007,1983,0,47,NA
ZAC,Calera,45204,22463,22741,6,7523,NA
ZAC,Cañitas de Felipe Pescador,8393,4143,4250,0,30,NA
ZAC,Concepción del Oro,12944,6494,6450,0,58,NA
ZAC,Cuauhtémoc,12590,6037,6553,0,71,NA
ZAC,Chalchihuites,11416,5554,5862,0,598,NA
ZAC,Fresnillo,230865,112299,118566,31,10394,NA
ZAC,Trinidad García de la Cadena,2884,1414,1470,0,43,NA
ZAC,Genaro Codina,8185,3932,4253,0,774,NA
ZAC,General Enrique Estrada,6325,3120,3205,0,415,NA
ZAC,General Francisco R. Murguía,21809,10634,11175,3,1790,NA
ZAC,El Plateado de Joaquín Amaro,1160,560,600,0,2,NA
ZAC,General Pánfilo Natera,23192,11224,11968,0,1095,NA
ZAC,Guadalupe,187918,91112,96806,84,13295,Zacatecas-Guadalupe
ZAC,Huanusco,4084,2013,2071,0,102,NA
ZAC,Jalpa,24093,11849,12244,5,3832,NA
ZAC,Jerez,59125,28635,30490,26,6586,NA
ZAC,Jiménez del Teul,4275,2126,2149,0,37,NA
ZAC,Juan Aldama,21806,10535,11271,3,4314,NA
ZAC,Juchipila,12627,5933,6694,0,250,NA
ZAC,Loreto,53441,26426,27015,29,6559,NA
ZAC,Luis Moya,13292,6556,6736,0,1579,NA
ZAC,Mazapil,17457,9006,8451,0,62,NA
ZAC,Melchor Ocampo,2938,1556,1382,1,208,NA
ZAC,Mezquital del Oro,2484,1201,1283,0,28,NA
ZAC,Miguel Auza,23827,11590,12237,6,1203,NA
ZAC,Momax,2404,1151,1253,0,302,NA
ZAC,Monte Escobedo,9129,4565,4564,9,1476,NA
ZAC,Morelos,12354,6106,6248,1,1212,Zacatecas-Guadalupe
ZAC,Moyahua de Estrada,3947,1849,2098,0,225,NA
ZAC,Nochistlán de Mejía,27750,13317,14433,0,1237,NA
ZAC,Noria de Ángeles,16864,8256,8608,0,315,NA
ZAC,Ojocaliente,43471,21193,22278,3,1948,NA
ZAC,Pánuco,17647,8737,8910,0,934,NA
ZAC,Pinos,73151,35513,37638,0,853,NA
ZAC,Río Grande,63880,30975,32905,0,4062,NA
ZAC,Sain Alto,22278,10778,11500,0,1645,NA
ZAC,El Salvador,2455,1236,1219,0,60,NA
ZAC,Sombrerete,62433,30449,31984,5,9496,NA
ZAC,Susticacán,1329,649,680,0,332,NA
ZAC,Tabasco,15484,7543,7941,0,931,NA
ZAC,Tepechitlán,8855,4227,4628,13,2516,NA
ZAC,Tepetongo,7071,3463,3608,6,1642,NA
ZAC,Teúl de González Ortega,5378,2637,2741,0,186,NA
ZAC,Tlaltenango de Sánchez Román,26645,12914,13731,6,5401,NA
ZAC,Valparaíso,32606,16032,16574,0,1790,NA
ZAC,Vetagrande,9796,4833,4963,1,151,NA
ZAC,Villa de Cos,35252,17650,17602,0,1891,NA
ZAC,Villa García,18745,9231,9514,2,2030,NA
ZAC,Villa González Ortega,13099,6376,6723,0,881,NA
ZAC,Villa Hidalgo,19155,9433,9722,0,163,NA
ZAC,Villanueva,30240,14793,15447,2,2912,NA
ZAC,Zacatecas,146147,70855,75292,1,12210,Zacatecas-Guadalupe
ZAC,Trancoso,19413,9505,9908,0,1014,NA
ZAC,Santa María de la Paz,2656,1305,1351,0,215,NA
